ADN	ad
Abkhasie	ab.ka.ˈzi
Abkhasien	ab.ka.ˈzi
Abyssin	a.bi.ˈsɛ̃
Abyssinie	a.bi.si.ˈni
Achille	a.ˈʃi
Achéron	a.ʃe.ˈʁõ
Adam	a.ˈdam
Aden	a.ˈdɛn
Adjarie	ad.ʒa.ˈʁi
Adonis	a.do.ˈni
Afghan	af.ˈgã
Afghane	af.ˈgan
Afghanistan	af.ga.ni.ˈstã
Africain	a.fʁi.ˈkɛ̃
Afrikander	a.fʁi.kã.ˈde
Afrique	a.ˈfʁik
Afrique du Nord	a.fʁik.dy.ˈnɔʁ
Afrique du Sud	a.fʁik.dy.ˈsyd
Agamemnon	a.ga.mɛ.ˈnõ
Agathe	a.ˈgat
Ajax	a.ˈʒaks
Albanais	al.ba.ˈnɛ
Albanie	al.ba.ˈni
Albe	alb
Albert	al.ˈbɛʁ
Alberta	al.bɛʁ.ˈta
Alep	a.ˈlɛp
Alexandre	a.lɛk.ˈsãdʁ
Alexandrie	a.lɛk.sã.ˈdʁi
Alger	al.ˈʒe
Algérie	al.ʒe.ˈʁi
Algérien	al.ʒe.ˈʁi
Allemagne	a.lə.ˈmanj
Allemagne de l'Ouest	a.lə.manj.də.ˈlwɛst
Allemand	a.lə.ˈmã
Allemande	a.lə.ˈmãd
Alost	a.ˈlɔst
Alpes	alp
Alpes graies	alp.ˈgʁɛ
Alsacien	al.sa.ˈsi
Amboine	ã.ˈbwan
Amsterdam	am.stɛʁ.ˈdam
Américain	a.me.ʁi.ˈkɛ̃
Amérique	a.me.ˈʁik
Amérique centrale	a.me.ʁik.sã.ˈtʁal
Amérique du Nord	a.me.ʁik.dy.ˈnɔʁ
Amérique du Sud	a.me.ʁik.dy.ˈsyd
Amérique septentrionale	a.me.ʁik.sɛp.tã.tʁjo.ˈnal
Andalou	ã.da.ˈlu
Andalouse	ã.da.ˈluz
Andalousie	ã.da.lu.ˈzi
Andorre	ã.ˈdɔʁ
Andrinople	ã.dʁi.ˈnopl
Anglais	ã.ˈglɛ
Angle	ãgl
Angleterre	ã.glə.ˈtɛʁ
Angolais	ã.gɔ.ˈlɛ
Anne	an
Annibal	a.ni.ˈbal
Annonciation	a.nõ.sja.ˈsjõ
Antarctique	ã.taʁk.ˈtik
Antillais	ã.ti.ˈjɛ
Antilles	ã.ˈtij
Antioche	ã.ˈsjoʃ
Antoine	ã.ˈtwan
Anvers	ã.ˈvɛʁ
Apache	a.ˈpaʃ
Apennins	a.pɛ.ˈnɛ̃
Aphrodite	a.fʁɔ.ˈdit
Apocalypse	a.po.ka.ˈlips
Apollon	a.pɔ.ˈlõ
Appalaches	a.pa.ˈlaʃ
Aquitaine	a.ki.ˈtɛn
Arabe	a.ˈʁab
Arabie	a.ʁa.ˈbi
Arcadie	aʁ.ka.ˈdi
Archimède	aʁ.ʃi.ˈmɛd
Ardennes	aʁ.ˈdɛn
Argentin	aʁ.ʒã.ˈtɛ̃
Argentine	aʁ.ʒã.ˈtin
Argus	aʁ.ˈgy
Ariane	a.ˈʁjan
Aristote	a.ʁi.ˈstɔt
Armorique	aʁ.mo.ˈʁik
Arménie	aʁ.me.ˈni
Arménien	aʁ.me.ˈni
Arménienne	aʁ.me.ˈnjɛn
Arras	a.ˈʁa
Aryen	aʁj
Asiate	az.ˈjat
Asiatique	az.ja.ˈtik
Asie	a.ˈzi
Asie Mineure	a.zi.mi.ˈnœʁ
Assomption	a.sõps.ˈjõ
Assyrie	as.sɛ̃.ˈʁi
Assyrien	as.sɛ̃.ˈʁi
Asturies	a.sty.ˈʁi
Atabasca	a.ta.ba.ˈska
Athénien	a.te.ˈni
Athènes	a.ˈtɛn
Atlas	at.ˈla
Attique	a.ˈtik
Augias	oʒ.ˈja
Auguste	o.ˈgyst
Aurigny	o.ʁi.ˈnji
Australie	o.stʁa.ˈli
Australien	o.stʁa.ˈli
Australienne	o.stʁa.ˈljɛn
Autriche	o.ˈtʁiʃ
Autrichien	o.tʁi.ˈʃi
Babel	ba.ˈbɛl
Babylone	ba.bi.ˈlon
Babylonie	ba.bi.lo.ˈni
Bacchus	bak.ˈʃy
Balinais	ba.li.ˈnɛ
Balkans	bal.ˈkã
Baléares	ba.ˈleaʁ
Bantou	bã.ˈtu
Barbade	baʁ.ˈbad
Barcelone	baʁ.sə.ˈlon
Barry	ba.ˈʁi
Barthélemy	baʁ.te.lã.ˈmi
Basque	bask
Batave	ba.ˈtav
Bavarois	ba.va.ˈʁwa
Bavière	ba.ˈvjɛʁ
Belge	bɛlʒ
Belgique	bɛl.ˈʒik
Belgrade	bɛl.ˈgʁad
Benelux	bə.nə.ˈly
Bengale	bã.ˈgal
Benoît	bə.ˈnwa
Berlin	bɛʁ.ˈlɛ̃
Berlinois	bɛʁ.li.ˈnwa
Bermudes	bɛʁ.ˈmyd
Berne	bɛʁn
Bernois	bɛʁ.ˈnwa
Bessarabie	bɛ.sa.ʁa.ˈbi
Bethléem	bɛt.ˈleɛm
Bible	bibl
Birman	biʁ.ˈman
Birmane	biʁ.ˈman
Birmanie	biʁ.ma.ˈni
Boer	be
Bohémien	boe.ˈmi
Bohême	boɛm
Bolivie	bɔ.li.ˈvi
Bolivien	bɔ.li.ˈvi
Boschiman	bo.ʃi.ˈmã
Bosnie	bo.ˈsni
Bosnien	bo.ˈsni
Bosphore	bo.ˈsfɔʁ
Bouddha	bu.ˈda
Brabant	bʁa.ˈbã
Brabançon	bʁa.bã.ˈsõ
Bretagne	bʁə.ˈtagn
Breton	bʁə.ˈtõ
Britannique	bʁi.ta.ˈnik
Bruges	bʁyʒ
Bruxelles	bʁyk.ˈsɛl
Brésil	bʁe.ˈzil
Brésilien	bʁe.zi.ˈli
Bulgare	byl.ˈgaʁ
Byzance	bi.ˈzãs
Bédouin	be.ˈdwɛ̃
Bâle	bal
Cachemire	ka.ʃə.ˈmiʁ
Calabre	ka.ˈlabʁ
Californie	ka.li.foʁ.ˈni
Californien	ka.li.foʁ.ˈni
Calvaire	kal.ˈvɛʁ
Calvin	kal.ˈvɛ̃
Cambodge	kã.ˈbɔdʒ
Cambodgien	kã.bɔ.ˈʒi
Cambodgienne	kã.bɔdʒ.ˈjɛn
Cameroun	ka.mə.ˈʁu
Canada	ka.na.ˈda
Canadien	ka.na.ˈdi
Canadienne	ka.na.ˈdjɛn
Capitole	ka.pi.ˈtɔl
Capricorne	ka.pʁi.ˈkɔʁn
Carpates	kaʁ.ˈpat
Carthage	kaʁ.ˈtaʒ
Carthaginois	kaʁ.ta.ʒi.ˈnwa
Cassandre	ka.ˈsãdʁ
Castillan	ka.sti.ˈjã
Castille	ka.ˈstij
Catalan	ka.ta.ˈlã
Catalogne	ka.ta.ˈlɔnj
Caton	ka.ˈtõ
Caucase	ko.ˈkaz
Caïn	ka.ˈjɛ̃
Celte	sɛlt
Cendrillon	sã.dʁi.ˈjõ
Cerbère	sɛʁ.ˈbɛʁ
Ceylan	sɛ.ˈlã
Ceylanais	sɛ.la.ˈnɛ
Chaldée	ʃal.ˈde
Chaldéen	ʃal.ˈde
Chanaan	ʃa.ˈnaã
Chandeleur	ʃã.də.ˈlœʁ
Charlemagne	ʃaʁ.lə.ˈmanj
Charybde	ʃa.ˈʁibd
Chenal Lost	ʃə.nal.ˈlɔst
Chili	ʃi.ˈli
Chilien	ʃi.ˈli
Chine	ʃin
Chinois	ʃi.ˈnwa
Christ	kʁist
Churchill	ʃyʁ.ˈʃi
Chutes Niagara	ʃyt.nja.ga.ˈʁa
Chypre	ʃipʁ
Chypriote	ʃi.ˈpʁjɔt
Cicéron	si.se.ˈʁõ
Cléopâtre	kleɔ.ˈpatʁ
Coblence	kɔ.ˈblãs
Cologne	kɔ.ˈlɔnj
Colomb	kɔ.ˈlõ
Colombie	kɔ.lõ.ˈbi
Colombien	kɔ.lõ.ˈbi
Columbia	kɔ.ly.bi.ˈja
Comines	ko.ˈmin
Congo	kõ.ˈgo
Copenhague	ko.pɛ.ˈnag
Coran	kɔ.ˈʁã
Cordoue	koʁ.ˈdu
Corinthe	ko.ˈʁɛ̃t
Cornouailles	kɔʁ.ˈnwaj
Corse	kɔʁs
Corée	kɔ.ˈʁe
Coréen	kɔ.ˈʁe
Coréene	kɔ.ˈʁeən
Corée du Nord	kɔ.ʁe.dy.ˈnɔʁ
Corée du Sud	kɔ.ʁe.dy.ˈsyd
Costaricien	ko.sta.ʁi.ˈsi
Costa Rica	ko.sta.ʁi.ˈka
Courtrai	kuʁ.ˈtʁɛ
Cracovie	kʁa.ko.ˈvi
Crimée	kʁi.ˈme
Croate	kʁot
Croatie	kʁo.ˈti
Croix du Sud	kʁwa.dy.ˈsyd
Crète	kʁɛt
Cuba	ky.ˈba
Cubain	ky.ˈbɛ̃
Cupidon	ky.pi.ˈdõ
Curaçao	ky.ʁa.ˈsao
Cyclades	si.ˈklad
Cypriote	si.ˈpʁjɔt
Cérès	se.ˈʁɛ
César	se.ˈzaʁ
Côte d'Ivoire	kot.di.ˈvwaʁ
Dakar	da.ˈkaʁ
Dalmate	dal.ˈmat
Dalmatie	dal.ma.ˈti
Damas	da.ˈma
Damoclès	da.mo.ˈklɛ
Danemark	da.nə.ˈmaʁk
Danois	da.ˈnwa
Danube	da.ˈnyb
Dardanelles	daʁ.da.ˈnɛl
Delphes	dəlf
Deutéronome	dø.te.ʁo.ˈnɔm
Diane	djan
Dieu	djø
Diogène	djo.ˈʒɛn
Djibouti	dʒi.bu.ˈti
Dominicain	do.mi.ni.ˈkɛ̃
Dominique	do.mi.ˈnik
Douvres	duvʁ
Dunkerque	dy.ˈkɛʁk
Ecossais	ə.ko.ˈsɛ
Ecossaise	ə.ko.ˈsɛz
Ecosse	ə.ˈkos
Ecriture sainte	ə.kʁi.tyʁ.ˈsɛ̃t
Eden	ə.ˈdɛn
Edimbourg	ə.dɛ̃.ˈbuʁ
Egypte	ɛ.ˈʒipt
Egyptien	ɛ.ʒi.ˈpsi
Elbe	əlb
Empire romain	ã.piʁ.ʁo.ˈmɛ̃
Enée	ə.ˈne
Eole	ɔl
Epiphanie	ə.pi.fa.ˈni
Erythrée	ə.ʁi.ˈtʁe
Escaut	ɛ.ˈsko
Espagne	ɛ.ˈspanj
Espagnol	ɛ.spa.ˈnjɔl
Espagnole	ɛ.spa.ˈnjɔl
Estonie	ɛ.sto.ˈni
Estonien	ɛ.sto.ˈni
Estonienne	ɛ.sto.ˈnjɛn
Ethiopie	ɛ.tjo.ˈpi
Ethiopien	ɛ.tjo.ˈpi
Etrusque	ə.ˈtʁysk
Euphrate	ø.ˈfʁat
Europe	ø.ˈʁɔp
Européen	ø.ʁɔ.ˈpe
Finlandaise	fi.lã.ˈdɛz
Finlande	fi.ˈlãd
Finnois	fi.ˈnwa
Finnoise	fi.ˈnwaz
Flamand	fla.ˈmã
Flandre	flãdʁ
Flandre Zélandaise	flãdʁ.ze.lã.ˈdɛz
Flessingue	fle.ˈsɛ̃g
Fleuve Churchill	flœv.ʃyʁ.ˈʃi
Fleuve Columbia	flœv.kɔ.ly.bi.ˈja
Fleuve Fraser	flœv.fʁa.ˈze
Floride	flo.ˈʁid
Fortune	foʁ.ˈtyn
France	fʁãs
Francfort	fʁãk.ˈfɔʁ
Français	fʁã.ˈsɛ
Française	fʁã.ˈsɛz
Fraser	fʁa.ˈze
Frise	fʁiz
Frison	fʁi.ˈzõ
Gabon	ga.ˈbõ
Galice	ga.ˈlis
Galicie	ga.li.ˈsi
Galles	gal
Gallois	ga.ˈlwa
Gand	gã
Gange	gãʒ
Gaule	gol
Gaulois	go.ˈlwa
Genèse	ʒə.ˈnɛz
Genève	ʒə.ˈnɛv
Germain	ʒɛʁ.ˈmɛ̃
Ghana	ga.ˈna
Ghanéen	ga.ˈne
Golfe d'Aden	gɔlf.da.ˈdɛn
Goth	got
Grammont	gʁa.ˈmõ
Grand Lac Salé	gʁã.lak.sa.ˈle
Grec	gʁɛk
Grecque	gʁɛk
Grenade	gʁə.ˈnad
Groenland	gʁœã.ˈlã
Groenlandais	gʁœã.lã.ˈdɛ
Groënland	gʁo.ˈlã
Groënlandais	gʁo.lã.ˈdɛ
Grèce	gʁɛs
Guadeloupe	ga.də.ˈlup
Guatemala	ga.tə.ma.ˈla
Guatémaltèque	ga.te.mal.ˈtɛk
Gueldre	gɛldʁ
Guinée	gi.ˈne
Guinée Equatoriale	gi.neə.ka.tɔ.ˈʁjal
Guyenne	gi.ˈjɛn
Gédéon	ʒe.ˈdeõ
Géorgie	ʒeɔʁ.ˈʒi
Géorgien	ʒeɔʁ.ˈʒi
Gênes	ʒɛn
Hambourg	ã.ˈbuʁ
Hannibal	a.ni.ˈbal
Hanovre	a.ˈnovʁ
Hawaii	o.ˈwɛ
Haïti	ai.ˈti
Hellade	ɛ.ˈlad
Helvétie	ɛl.ve.ˈsi
Helvète	ɛl.ˈvɛt
Hercule	ɛʁ.ˈkyl
Hermès	ɛʁ.ˈmɛ
Himalaya	i.ma.lɛ.ˈja
Hippocrate	i.po.ˈkʁat
Hollandais	ɔ.lã.ˈdɛ
Hollande	ɔ.ˈlãd
Hollande septentrionale	ɔ.lãd.sɛp.tã.tʁjo.ˈnal
Homère	o.ˈmɛʁ
Honduras	õ.dy.ˈʁa
Hondurien	õ.dy.ˈʁi
Hondurienne	õ.dy.ˈʁjɛn
Hongrie	õ.ˈgʁi
Hongrois	õ.ˈgʁwa
Hongroise	õ.ˈgʁwaz
Hong Kong	õŋ.ˈkõŋ
Hébreu	e.ˈbʁø
Hébrides	e.ˈbʁid
Hélène	e.ˈlɛn
Iles normandes	il.nɔʁ.ˈmãd
Ile Kénosha	il.ke.no.ˈza
Ile Remprouix	il.ʁã.ˈpʁwi
Ile de Baffin	il.də.ba.ˈfɛ̃
Ile de Sable	il.də.ˈsabl
Ile de Vancouver	il.də.vã.ku.ˈve
Ile du Diable	il.dy.ˈdjabl
Ile d'Anticosti	il.dã.ti.ko.ˈsti
Ile d'Ellesmere	il.dɛl.ˈsməʁ
Iliade	i.ˈljad
Inde	ɛ̃d
Indien	ɛ̃.ˈdi
Indienne	ɛ̃.ˈdjɛn
Indochine	ɛ̃.do.ˈʃin
Indonésie	ɛ̃.do.ne.ˈzi
Indonésien	ɛ̃.do.ne.ˈzi
Indonésienne	ɛ̃.do.nez.ˈjɛn
Irak	i.ˈʁak
Irakien	i.ʁa.ˈki
Iran	i.ˈʁã
Iranien	i.ʁa.ˈni
Iranienne	i.ʁa.ˈnjɛn
Irlandais	iʁ.lã.ˈdɛ
Irlandaise	iʁ.lã.ˈdɛz
Irlande	iʁ.ˈlãd
Irlande du Nord	iʁ.lãd.dy.ˈnɔʁ
Islandais	is.lã.ˈdɛ
Islande	is.ˈlãd
Israël	is.ˈʁal
Italie	i.ta.ˈli
Italien	i.ta.ˈli
Italienne	i.ta.ˈljɛn
Jacob	ʒa.ˈkɔb
Jacques	ʒak
Jamaïque	ʒa.ˈmaik
Japon	ʒa.ˈpõ
Japonais	ʒa.pɔ.ˈnɛ
Japonaise	ʒa.pɔ.ˈnɛz
Java	ʒa.ˈva
Javanais	ʒa.va.ˈnɛ
Javanaise	ʒa.va.ˈnɛz
Jordanie	ʒɔʁ.da.ˈni
Jordanien	ʒɔʁ.da.ˈni
Joseph	ʒo.ˈzə
Josué	ʒo.ˈsye
Jourdain	ʒuʁ.ˈdɛ̃
Juif	ʒɥif
Junon	ʒy.ˈnõ
Jupiter	ʒy.pi.ˈte
Jéricho	ʒe.ʁi.ˈʃo
Jérusalem	ʒe.ʁy.za.ˈlɛm
Kenya	kə.ˈnia
Kenyan	kə.ˈniã
Khmer	kme
Kremlin	kʁãm.ˈlɛ̃
Kurde	kyʁd
Kurdistan	kyʁ.di.ˈstã
Lac Léman	la.kle.ˈmã
Laos	lao
Laotien	laɔ.ˈti
Lapon	la.ˈpõ
Laponie	la.po.ˈni
Laponne	la.ˈpɔn
Laurentides	lo.ʁã.ˈtid
La Havane	laa.ˈvan
La Haye	laɛj
Letton	lɛ.ˈtõ
Lettonie	lɛ.to.ˈni
Lettonne	lɛ.ˈtɔn
Leyde	lɛd
Le Caire	lə.ˈkɛʁ
Liban	li.ˈbã
Libanais	li.ba.ˈnɛ
Libye	li.ˈbi
Libyen	li.ˈbi
Libéria	li.be.ˈʁja
Libérien	li.be.ˈʁi
Lierre	ljɛʁ
Lisbonne	lis.ˈbɔn
Lituanie	li.tya.ˈni
Lituanien	li.tya.ˈni
Lituanienne	li.tya.ˈnjɛn
Livonie	li.vo.ˈni
Livonien	li.vo.ˈni
Livourne	li.ˈvuʁn
Liége	ljeʒ
Liège	ljɛʒ
Londonien	lõ.do.ˈni
Londres	lõdʁ
Lorraine	lo.ˈʁɛn
Louvain	lu.ˈvɛ̃
Lucerne	ly.ˈsɛʁn
Luxembourg	lyk.sã.ˈbuʁ
Luxemburgeois	lyk.sã.byʁ.ˈʒwa
Lyon	liõ
Machiavel	ma.kja.ˈvɛl
Mackenzie	ma.kã.ˈzi
Macédoine	ma.se.ˈdwan
Macédonien	ma.se.do.ˈni
Madagascar	ma.da.ga.ˈskaʁ
Madone	ma.ˈdɔn
Madrid	ma.ˈdʁi
Mahomet	mao.ˈmɛ
Majorque	ma.ˈʒɔʁk
Malais	ma.ˈlɛ
Malaisie	ma.lɛ.ˈzi
Malaisien	ma.lɛ.ˈzi
Malawi	ma.lo.ˈwi
Mali	ma.ˈli
Malines	ma.ˈlin
Maltais	mal.ˈtɛ
Malte	malt
Mammon	ma.ˈmõ
Mandchourie	mãd.ʃu.ˈʁi
Manille	ma.ˈnij
Manitoba	ma.ni.tɔ.ˈba
Marcq	maʁk
Mariannes	ma.ˈʁjan
Marie	ma.ˈʁi
Maroc	ma.ˈʁok
Marocain	ma.ʁo.ˈkɛ̃
Maroni	ma.ʁo.ˈni
Mars	maʁ
Marseille	maʁ.ˈsɛj
Mathusalem	ma.ty.za.ˈlɛm
Maure	moʁ
Mauritanie	mo.ʁi.ta.ˈni
Mauritanien	mo.ʁi.ta.ˈni
Mayence	mɛ.ˈjãs
Mecque	mɛk
Mercure	mɛʁ.ˈkyʁ
Messie	mɛ.ˈsi
Messine	mɛ.ˈsin
Meuse	møz
Mexicain	mɛk.si.ˈkɛ̃
Mexicaine	mɛk.si.ˈkɛn
Mexico	mɛk.si.ˈko
Mexique	mɛk.ˈsik
Milan	mi.ˈlã
Minerve	mi.ˈnɛʁv
Moldave	mɔl.ˈdav
Moldavie	mɔl.da.ˈvi
Moluques	mɔ.ˈlyk
Moluquois	mɔ.ly.ˈkwa
Monaco	mo.na.ˈko
Mongolie	mõ.gɔ.ˈli
Monténégrin	mõ.te.ne.ˈgʁɛ̃
Monténégro	mõ.te.ne.ˈgʁo
Monégasque	mo.ne.ˈgask
Moravie	mɔ.ʁa.ˈvi
More	mɔʁ
Morphée	mɔʁ.ˈfe
Moscou	mo.ˈsku
Moscovite	mo.sko.ˈvit
Moselle	mo.ˈzɛl
Moïse	moiz
Munich	my.ˈniʃ
Mycènes	mi.ˈsɛn
Méditerranée	me.di.tɛ.ʁa.ˈne
Méduse	me.ˈdyz
Mélanésie	me.la.ne.ˈzi
Mélanésien	me.la.ne.ˈzi
Méphistophélès	me.fi.sto.fe.ˈlɛ
Mésopotamie	me.zɔ.pɔ.ta.ˈmi
Nabuchodonosor	na.by.ʃɔ.do.no.ˈzɔʁ
Namur	na.ˈmyʁ
Nankin	nã.ˈkɛ̃
Naples	napl
Napolitain	na.pɔ.li.ˈtɛ̃
Nemrod	nãm.ˈʁɔ
Neptune	nɛp.ˈtyn
Nicaragua	ni.ka.ʁa.ˈga
Nicaraguayen	ni.ka.ʁa.ˈgɛj
Niger	ni.ˈʒe
Nigeria	ni.ʒə.ˈʁja
Nigérian	ni.ʒe.ˈʁjã
Nigérien	ni.ʒe.ˈʁi
Nil	nil
Nimègue	ni.ˈmɛg
Noir	nwaʁ
Nordafricain	nɔʁ.da.fʁi.ˈkɛ̃
Normand	nɔʁ.ˈmã
Norvégien	nɔʁ.ve.ˈʒi
Norvège	nɔʁ.ˈvɛʒ
Noé	noe
Néerlandais	neɛʁ.lã.ˈdɛ
Néerlandaise	neɛʁ.lã.ˈdɛz
Némésis	ne.me.ˈzi
Népal	ne.ˈpal
Népalais	ne.pa.ˈlɛ
Océanie	ɔ.sea.ˈni
Olympe	ɔ.ˈlip
Ontario	õ.ta.ˈʁjo
Orange	o.ˈʁãʒ
Orcades	ɔʁ.ˈkad
Orphée	ɔʁ.ˈfe
Ostende	o.ˈstãd
Ostrogoth	o.stʁo.ˈgɔt
Oural	u.ˈʁal
Pacifique	pa.si.ˈfik
Pakistan	pa.ki.ˈstã
Pakistanais	pa.ki.sta.ˈnɛ
Pakistanaise	pa.ki.sta.ˈnɛz
Palestine	pa.lɛ.ˈstin
Palestinien	pa.lɛ.sti.ˈni
Pan	pã
Panam	pa.ˈnam
Panama	pa.na.ˈma
Paname	pa.ˈnam
Panaméen	pa.na.ˈme
Panaméenne	pa.na.ˈmeɛn
Pandore	pã.ˈdɔʁ
Papou	pa.ˈpu
Paris	pa.ˈʁi
Parisien	pa.ʁi.ˈzi
Parthe	paʁt
Passe Lower	pas.lo.ˈve
Pentateuque	pã.ta.ˈtøk
Pentecôte	pã.tə.ˈkot
Persan	pɛʁ.ˈsã
Persane	pɛʁ.ˈsan
Perse	pɛʁs
Petit Poucet	pə.ti.pu.ˈsɛ
Philippin	fi.li.ˈpɛ̃
Philippine	fi.li.ˈpin
Philippines	fi.li.ˈpin
Platon	pla.ˈtõ
Pluton	ply.ˈtõ
Pologne	pɔ.ˈlonj
Polonais	pɔ.lo.ˈnɛ
Polonaise	pɔ.lo.ˈnɛz
Polynésie	pɔ.li.ne.ˈzi
Polynésien	pɔ.li.ne.ˈzi
Poméranie	pɔ.me.ʁa.ˈni
Porto	pɔʁ.ˈto
Portugais	pɔʁ.ty.ˈgɛ
Portugaise	pɔʁ.ty.ˈgɛz
Portugal	pɔʁ.ty.ˈgal
Prague	pʁag
Protée	pʁɔ.ˈte
Prusse	pʁys
Prussien	pʁy.ˈsi
Ptolémée	ptɔ.le.ˈme
Pégase	pe.ˈgaz
Pékin	pe.ˈkɛ̃
Péninsule Ministikawatin	pe.nɛ̃.syl.mi.ni.sti.ko.wa.ˈtɛ̃
Pénélope	pe.ne.ˈlɔp
Pérou	pe.ˈʁu
Pâques	pak
Pâris	pa.ˈʁi
Québec	ke.ˈbɛk
Rameaux	ʁa.ˈmo
Ratisbonne	ʁa.tis.ˈbɔn
Reims	ʁɛ̃
Rhin	ʁɛ̃
Rhodésie	ʁo.de.ˈzi
Rhénanie	ʁe.na.ˈni
Rhône	ʁon
Richard	ʁi.ˈʃaʁ
Rivière Churchill	ʁi.vjɛʁ.ʃyʁ.ˈʃi
Romain	ʁo.ˈmɛ̃
Rome	ʁɔm
Roumain	ʁu.ˈmɛ̃
Roumaine	ʁu.ˈmɛn
Roumanie	ʁu.ma.ˈni
Rubicon	ʁy.bi.ˈkõ
Russe	ʁys
Russie	ʁy.ˈsi
Républic Dominicaine	ʁe.py.blik.do.mi.ni.ˈkɛn
Sagittaire	sa.ʒi.ˈtɛʁ
Sahara	saa.ˈʁa
Samarie	sa.ma.ˈʁi
Sardaigne	saʁ.ˈdɛnj
Sarde	saʁd
Satan	sa.ˈtã
Saturne	sa.ˈtyʁn
Saxe	saks
Saxon	sak.ˈsɔn
Scandinave	skã.di.ˈnav
Scandinavie	skã.di.na.ˈvi
Scylla	si.ˈla
Seine	sɛn
Serbe	sɛʁb
Serbie	sɛʁ.ˈbi
Seychelles	sɛ.ˈʃɛl
Siam	sjam
Sibérie	si.be.ˈʁi
Sicile	si.ˈsil
Sicilien	si.si.ˈli
Sicilienne	si.si.ˈljɛn
Singapour	sɛ̃.ga.ˈpuʁ
Singapourien	sɛ̃.ga.pu.ˈʁi
Slave	slav
Slavon	sla.ˈvõ
Slovaque	slo.ˈvak
Slovaquie	slo.va.ˈki
Slovénie	slo.ve.ˈni
Slovène	slo.ˈvɛn
Somalie	so.ma.ˈli
Somalien	so.ma.ˈli
Sophie	so.ˈfi
Soudan	su.ˈdã
Soudanais	su.da.ˈnɛ
Sparte	spaʁt
Spitzberg	spidz.ˈbɛʁg
Strasbourg	stʁas.ˈbuʁ
Styrie	sti.ˈʁi
Styx	sti
Suisse	sɥis
Surinam	sy.ʁi.ˈnam
Surinamien	sy.ʁi.na.ˈmi
Surinamienne	sy.ʁi.na.ˈmjɛn
Suédois	sye.ˈdwa
Suède	syɛd
Syrie	sɛ̃.ˈʁi
Syrien	sɛ̃.ˈʁi
Sémite	se.ˈmit
Sénégal	se.ne.ˈgal
Sénégalais	se.ne.ga.ˈlɛ
Séville	se.ˈvil
Tage	taʒ
Talmud	tal.ˈmy
Tamise	ta.ˈmiz
Tanger	tã.ˈʒe
Tantale	tã.ˈtal
Tanzanie	tã.za.ˈni
Tanzanien	tã.za.ˈni
Tatare	ta.ˈtaʁ
Tchad	tʃa
Tchécoslovaque	tʃe.kos.lo.ˈvak
Tchécoslovaquie	tʃe.kos.lo.va.ˈki
Tchèque	tʃɛk
Texan	tɛk.ˈsan
Texane	tɛk.ˈsan
Texas	tɛk.ˈsa
Thaï	tai
Thaïlandais	tai.lã.ˈdɛ
Thaïlandaise	tai.lã.ˈdɛz
Thaïlande	tai.ˈlãd
Tibet	ti.ˈbɛ
Tibre	tibʁ
Tibétain	ti.bɛ.ˈtɛ̃
Tibère	ti.ˈbɛʁ
Tigre	tigʁ
Togo	to.ˈgo
Tokyo	tɔ.ˈkjo
Toussaint	tu.ˈsɛ̃
Transylvanie	tʁã.sil.va.ˈni
Troie	tʁwa
Troyen	tʁwaj
Trèves	tʁɛv
Tunesie	ty.nə.ˈzi
Tunis	ty.ˈni
Turc	tyʁk
Turin	ty.ˈʁɛ̃
Turkménistan	tyʁk.me.ni.ˈstã
Turque	tyʁk
Turquie	tyʁ.ˈki
Ukraine	y.ˈkʁɛn
Ukrainien	y.kʁɛ.ˈni
Ukrainienne	y.kʁɛ.ˈnjɛn
Ulysse	y.ˈlis
Union Européenne	y.njõø.ʁɔ.ˈpeɛn
Uruguay	y.ʁy.ˈgɛj
Valachie	va.la.ˈʃi
Valence	va.ˈlãs
Varsovie	vaʁ.so.ˈvi
Vatican	va.ti.ˈkã
Venise	və.ˈniz
Verseau	vɛʁ.ˈso
Victoria	vik.tɔ.ˈʁja
Vienne	vjɛn
Viennois	vjɛ.ˈnwa
Viennoise	vjɛ.ˈnwaz
Vietnamien	vjɛt.na.ˈmi
Vietnamienne	vjɛt.na.ˈmjɛn
Viking	vi.ˈkiŋ
Visigoth	vi.zi.ˈgɔt
Vistule	vi.ˈstyl
Volga	vɔl.ˈga
Volta Noire	vɔl.ta.ˈnwaʁ
Vosges	vosʒ
Vulcain	vyl.ˈkɛ̃
Vulgate	vyl.ˈgat
Vénus	ve.ˈny
WC	wk
Wallonie	wa.lo.ˈni
Westphalie	wɛst.pa.ˈli
Wisigoth	wi.zi.ˈgɔt
Yougoslave	ju.gos.ˈlav
Yougoslavie	ju.gos.la.ˈvi
Ypres	ipʁ
Yukon	jy.ˈkõ
Yémen	je.ˈmɛn
Yéménite	je.me.ˈnit
Zambie	zã.ˈbi
Zambien	zã.ˈbi
Zanzibar	zã.zi.ˈbaʁ
Zaïre	zaiʁ
Zeus	zø
Zimbabwe	zɛ̃.ˈbab
Zoulou	zu.ˈlu
Zélandais	ze.lã.ˈdɛ
Zélande	ze.ˈlãd
abaissement	a.bɛ.ˈsəm
abaisser	a.bɛ.ˈse
abandon	a.bã.ˈdõ
abandonner	a.bã.dɔ.ˈne
abandonné	a.bã.dɔ.ˈne
abaque	a.ˈbak
abasourdir	a.ba.zuʁ.ˈdiʁ
abasourdissement	a.ba.zuʁ.di.ˈsəm
abats	a.ˈba
abattage	a.ba.ˈtaʒ
abattant	a.ba.ˈtã
abattement	a.ba.ˈtəm
abattis	a.ba.ˈti
abattoir	a.ba.ˈtwaʁ
abattre	a.ˈbatʁ
abbatial	a.ba.ˈsjal
abbaye	a.ˈbei
abbesse	a.ˈbɛs
abbé	a.ˈbe
abc	abk
abcès	ab.ˈsɛ
abdication	ab.di.ka.ˈsjõ
abdiquer	ab.di.ˈke
abdomen	ab.do.ˈmɛn
abdominal	ab.do.mi.ˈnal
abducteur	ab.dyk.ˈtœʁ
abeille	a.ˈbɛj
aberrant	a.bɛ.ˈʁã
aberration	a.bɛ.ʁa.ˈsjõ
abhorrer	a.bɔ.ˈʁe
abiogenèse	a.bjɔ.ʒə.ˈnɛz
abject	ab.ˈʒɛkt
abjection	ab.ʒɛk.ˈsjõ
abjuration	ab.ʒy.ʁa.ˈsjõ
abjurer	ab.ʒy.ˈʁe
abkhasien	ab.ka.ˈzi
ablatif	a.bla.ˈtif
abnégacion	ab.ne.ga.ˈsjõ
abnégation	ab.ne.ga.ˈsjõ
abois	a.ˈbwa
abolir	a.bɔ.ˈliʁ
abolition	a.bɔ.li.ˈsjõ
abolitionniste	a.bɔ.li.sjo.ˈnist
abominable	a.bo.mi.ˈnabl
abomination	a.bo.mi.na.ˈsjõ
abominer	a.bo.mi.ˈne
abondamment	a.bõ.ˈdam
abondance	a.bõ.ˈdãs
abondant	a.bõ.ˈdã
abonder	a.bõ.ˈde
abonnement	a.bo.ˈnəm
abonné	a.bɔ.ˈne
abord	a.ˈbɔʁ
abordable	a.bɔʁ.ˈdabl
aborder	a.bɔʁ.ˈde
abords	a.ˈbɔʁ
aborigène	a.bo.ʁi.ˈʒɛn
abortif	a.bɔʁ.ˈtif
aboucher	a.bu.ˈʃe
abouler	a.bu.ˈle
abouter	a.bu.ˈte
aboutir	a.bu.ˈtiʁ
aboutissement	a.bu.ti.ˈsəm
aboyer	a.bwa.ˈje
aboyer à	a.bwa.ˈjea
abracadabrant	a.bʁa.ka.da.ˈbʁã
abrasif	a.bʁa.ˈzif
abreuver	a.bʁœ.ˈve
abreuvoir	a.bʁœ.ˈvwaʁ
abri	a.ˈbʁi
abricot	a.bʁi.ˈko
abricotier	a.bʁi.kɔ.ˈtje
abriter	a.bʁi.ˈte
abrogation	a.bʁɔ.ga.ˈsjõ
abroger	a.bʁɔ.ˈʒe
abrupt	a.ˈbʁypt
abruptement	a.bʁyp.ˈtəm
abrégement	a.bʁe.ˈʒəm
abréger	a.bʁe.ˈʒe
abrégé	a.bʁe.ˈʒe
abrévation	a.bʁe.va.ˈsjõ
abscisse	ab.ˈsis
absence	ab.ˈsãs
absent	abs
absinthe	ab.ˈsɛ̃t
absolu	ab.sɔ.ˈly
absolument	ab.sɔ.ˈlym
absolutisme	ab.sɔ.ly.ˈtism
absorbant	ab.sɔʁ.ˈbã
absorber	ab.sɔʁ.ˈbe
absorption	ab.sɔʁps.ˈjõ
abstension totale d'alcool	ab.stã.sjõ.to.tal.dal.ˈkɔl
abstention	ab.stã.ˈtjõ
abstraction	ab.stʁak.ˈsjõ
abstraire	ab.ˈstʁɛʁ
abstrait	ab.ˈstʁɛ
absurde	ab.ˈsyʁd
absurdité	ab.syʁ.di.ˈte
abus	a.ˈby
abuser	a.by.ˈze
abusif	a.by.ˈzif
abusivement	a.by.zi.ˈvəm
abyssin	a.bi.ˈsɛ̃
abécédaire	a.be.se.ˈdɛʁ
abêtir	a.bɛ.ˈtiʁ
abîme	a.ˈbim
abîmer	a.bi.ˈme
acabit	a.ka.ˈbi
acacia	a.ka.ˈsja
académicien	a.ka.de.mi.ˈsi
académie	a.ka.de.ˈmi
académique	a.ka.de.ˈmik
acanthe	a.ˈkãt
acarien	a.ka.ˈʁi
accaparer	a.ka.pa.ˈʁe
accent	aks
accentuer	ak.sã.ˈtye
accent circonflexe	aks.siʁ.kõ.ˈflɛks
acceptable	ak.sɛp.ˈtabl
accepter	ak.sɛp.ˈte
accepteur	ak.sɛp.ˈtœʁ
accepté	ak.sɛp.ˈte
accessible	ak.sɛ.ˈsibl
accessoire	ak.sɛ.ˈswaʁ
accident	ak.ˈsid
accidentel	ak.si.dã.ˈtɛl
accidentellement	ak.si.dã.tɛ.ˈləm
accidenté	ak.si.dã.ˈte
acclamation	a.kla.ma.ˈsjõ
acclamer	a.kla.ˈme
acclimatation	a.kli.ma.ta.ˈsjõ
acclimatement	a.kli.ma.ˈtəm
accolade	a.kɔ.ˈlad
accommodant	a.ko.mɔ.ˈdã
accommodement	a.ko.mɔ.ˈdəm
accommoder	a.ko.mɔ.ˈde
accomodation	a.kɔ.mɔ.da.ˈsjõ
accompagnateur	a.kõ.pa.nja.ˈtœʁ
accompagnatrice	a.kõ.pa.nja.ˈtʁis
accompagnement	a.kõ.pa.ˈnjəm
accompagner	a.kõ.pa.ˈnje
accompli	a.kõ.ˈpli
accomplir	a.kõ.ˈpliʁ
accomplissement	a.kõ.pli.ˈsəm
accord	a.ˈkɔʁ
accordailles	a.koʁ.ˈdaj
accorder	a.kɔʁ.ˈde
accordé	a.kɔʁ.ˈde
accordée	a.kɔʁ.ˈde
accordéon	a.kɔʁ.ˈdeõ
accordéoniste	a.kɔʁ.deo.ˈnist
accotement	a.kɔ.ˈtəm
accoter	a.kɔ.ˈte
accotoir	a.ko.ˈtwaʁ
accoucher	a.ku.ˈʃe
accoucheur	a.ku.ˈʃœʁ
accoucheuse	a.ku.ˈʃøz
accouchée	a.ku.ˈʃe
accoudoir	a.ku.ˈdwaʁ
accouplement	a.ku.ˈpləm
accoupler	a.ku.ˈple
accoutumer	a.ku.ty.ˈme
accoutumé	a.ku.ty.ˈme
accrocher	a.kʁɔ.ˈʃe
accroissement	a.kʁwa.ˈsəm
accroître	a.ˈkʁwatʁ
accréditer	a.kʁe.di.ˈte
accu	a.ˈkœ̃
accueil	a.ˈkœj
accueillir	a.kœ.ˈjiʁ
accumulateur	a.ky.my.la.ˈtœʁ
accumulation	a.ky.my.la.ˈsjõ
accumulator	a.ky.my.la.ˈtɔʁ
accumuler	a.ky.my.ˈle
accusateur	a.ky.za.ˈtœʁ
accusatif	a.ky.za.ˈtif
accusation	a.ky.za.ˈsjõ
accuser	a.ky.ˈze
accusé	a.ky.ˈze
accusé de réception	a.ky.ze.də.ʁe.sɛps.ˈjõ
accéleration	ak.se.lə.ʁa.ˈsjõ
accélerer	ak.se.lə.ˈʁe
accélérateur	ak.se.le.ʁa.ˈtœʁ
accélération	ak.se.le.ʁa.ˈsjõ
accélérer	ak.se.le.ˈʁe
accès	ak.ˈsɛ
acerbe	a.ˈsɛʁb
achat	a.ˈʃa
acheteur	a.ʃə.ˈtœʁ
achever	a.ʃə.ˈve
achevé	a.ʃə.ˈve
achillée	a.ˈʃje
achopper	a.ʃɔ.ˈpe
acide	a.ˈsid
acidifier	a.si.di.ˈfje
acidité	a.si.di.ˈte
acier	a.ˈsje
acné	ak.ˈne
acolyte	a.ko.ˈlit
acompte	a.ˈkõt
aconit	a.ko.ˈni
acoustique	a.ku.ˈstik
acquisition	a.ki.zi.ˈsjõ
acquit	a.ˈki
acquittement	a.ki.ˈtəm
acquitter	a.ki.ˈte
acquéreur	a.ke.ˈʁœʁ
acquérir	a.ke.ˈʁiʁ
acquérir péniblement	a.ke.ʁiʁ.pe.ni.ˈbləm
acre	akʁ
acrobate	a.kʁo.ˈbat
acrobaties	a.kʁɔ.ba.ˈsi
acrobatique	a.kʁo.ba.ˈtik
acrostiche	a.kʁɔ.ˈstiʃ
acte	akt
acteur	ak.ˈtœʁ
actif	ak.ˈtif
action	ak.ˈsjõ
actionnaire	ak.sjɔ.ˈnɛʁ
actionner	ak.sjɔ.ˈne
action au porteur	ak.sjõo.pɔʁ.ˈtœʁ
action de compagnie maritime	ak.sjõ.də.kõ.pa.nji.ma.ʁi.ˈtim
action nominative	ak.sjõ.no.mi.na.ˈtiv
activer	ak.ti.ˈve
activité	ak.ti.vi.ˈte
actrice	ak.ˈtʁis
actualité	ak.tya.li.ˈte
actualités	ak.tya.li.ˈte
actuel	ak.ˈtyɛl
actuellement	ak.tyɛ.ˈləm
acuité	a.kɥi.ˈte
acupuncture	a.ky.põk.ˈtyʁ
acéré	a.se.ˈʁe
acétate	a.se.ˈtat
acétone	a.se.ˈton
acétylène	a.se.ti.ˈlɛn
adagio	a.dadʒ.ˈjo
adaptation	a.dap.ta.ˈsjõ
adaptation musicale	a.dap.ta.sjõ.my.zi.ˈkal
adapter	a.dap.ˈte
adapteur	a.dap.ˈtœʁ
adapté	a.dap.ˈte
addition	a.di.ˈsjõ
additionnel	a.di.sjo.ˈnɛl
additionner	a.di.sjɔ.ˈne
adhérent	a.ˈdeʁ
adhérents	a.ˈdeʁ
adhérer	a.de.ˈʁe
adhésif	a.de.ˈzif
adhésion	a.dez.ˈjõ
adieu	a.ˈdjø
adjacent	ad.ˈʒas
adjectif	ad.ʒɛk.ˈtif
adjoindre	ad.ˈʒwɛ̃dʁ
adjoint	ad.ˈʒwɛ̃
adjoint au maire	ad.ʒwɛ̃o.ˈmɛʁ
adjudant	ad.ʒy.ˈdã
adjudication	ad.ʒy.di.ka.ˈsjõ
adjuger	ad.ʒy.ˈʒe
admettre	ad.ˈmɛtʁ
administrateur	ad.mi.ni.stʁa.ˈtœʁ
administratif	ad.mi.ni.stʁa.ˈtif
administration	ad.mi.ni.stʁa.ˈsjõ
administrer	ad.mi.ni.ˈstʁe
admirable	ad.mi.ˈʁabl
admirateur	ad.mi.ʁa.ˈtœʁ
admiratif	ad.mi.ʁa.ˈtif
admiration	ad.mi.ʁa.ˈsjõ
admiratrice	ad.mi.ʁa.ˈtʁis
admirer	ad.mi.ˈʁe
admonester	ad.mo.nɛ.ˈste
ado	a.ˈdo
adolescence	a.dɔ.lɛ.ˈsãs
adolescent	a.dɔ.ˈlɛs
adolescente	a.dɔ.lɛ.ˈsãt
adonis	a.do.ˈni
adopter	a.dɔp.ˈte
adoptif	a.dɔp.ˈtif
adoption	a.dops.ˈjõ
adorable	a.dɔ.ˈʁabl
adorateur	a.do.ʁa.ˈtœʁ
adoration	a.dɔ.ʁa.ˈsjõ
adoratrice	a.do.ʁa.ˈtʁis
adorer	a.dɔ.ˈʁe
adorée	a.dɔ.ˈʁe
adresse	a.ˈdʁɛs
adresser	a.dʁɛ.ˈse
adresser la parole à	a.dʁɛ.se.la.pa.ʁɔ.ˈla
adroit	a.ˈdʁwa
adrénaline	a.dʁe.na.ˈlin
aduler	a.dy.ˈle
adulte	a.ˈdylt
adultère	a.dyl.ˈtɛʁ
adverbe	ad.ˈvɛʁb
adverbial	ad.vɛʁ.ˈbjal
adversaire	ad.vɛʁ.ˈsɛʁ
adéquate	a.de.ˈkwat
afecté	a.fɛk.ˈte
affable	a.ˈfabl
affaiblir	a.fɛ.ˈbliʁ
affaire	a.ˈfɛʁ
affaires	a.ˈfɛʁ
affectation	a.fɛk.ta.ˈsjõ
affecter	a.fɛk.ˈte
affection	a.fɛk.ˈsjõ
affectueux	a.fɛk.ˈtyø
affecté	a.fɛk.ˈte
affermer	a.fɛʁ.ˈme
affiche	a.ˈfiʃ
afficher	a.fi.ˈʃe
affiler	a.fi.ˈle
affilié	a.fi.ˈlje
affinier	a.fi.ˈnje
affinité	a.fi.ni.ˈte
affirmatif	a.fiʁ.ma.ˈtif
affirmation	a.fiʁ.ma.ˈsjõ
affirmer	a.fiʁ.ˈme
affixe	a.ˈfiks
affliction	a.flik.ˈsjõ
affliger	a.fli.ˈʒe
affligé	a.fli.ˈʒe
affluent	a.ˈfly
afflux	a.ˈfly
afflux de sang	a.fly.də.ˈsã
affolement	a.fɔ.ˈləm
affranchi	a.fʁã.ˈʃi
affranchir	a.fʁã.ˈʃiʁ
affreusement	a.fʁø.ˈzəm
affreux	a.ˈfʁø
affreux jojo	a.fʁø.ʒo.ˈʒo
affriolant	afʁ.jo.ˈlã
affront	a.ˈfʁõ
affronter	a.fʁõ.ˈte
afféterie	a.fɛ.tə.ˈʁi
afghan	af.ˈgã
afin de	a.fɛ̃.ˈdə
afin de pour	a.fɛ̃.də.ˈpuʁ
afin que	a.fɛ̃.ˈkə
africain	a.fʁi.ˈkɛ̃
agacement	a.ga.ˈsəm
agacer	a.ga.ˈse
agape	a.ˈgap
agate	a.ˈgat
agave	a.ˈgav
agaçant	a.ga.ˈsã
agence	a.ˈʒãs
agence de voyage	a.ʒãs.də.vwa.ˈjaʒ
agenda	a.ʒɛ̃.ˈda
agent	aʒ
agent de police	aʒ.də.pɔ.ˈlis
aggloméré	a.glɔ.me.ˈʁe
agglutinant	a.gly.ti.ˈnã
agglutiner	a.gly.ti.ˈne
aggraver	a.gʁa.ˈve
agile	a.ˈʒil
agir	a.ˈʒiʁ
agir avec abnégation	a.ʒi.ʁa.vɛ.kab.ne.ga.ˈsjõ
agir avec affectation	a.ʒi.ʁa.vɛ.ka.fɛk.ta.ˈsjõ
agir en hypocrite	a.ʒi.ʁi.po.ˈkʁit
agir selon	a.ʒiʁ.sə.ˈlõ
agissant	a.ʒi.ˈsã
agitation	a.ʒi.ta.ˈsjõ
agiter	a.ʒi.ˈte
agité	a.ʒi.ˈte
agneau	a.ˈnjo
agnostique	a.njɔ.ˈstik
agonie	a.go.ˈni
agoniser	a.go.ni.ˈze
agoraphobie	a.gɔ.ʁa.fɔ.ˈbi
agrafe	a.ˈgʁaf
agrafer	a.gʁa.ˈfe
agrafe de vêtement	a.gʁaf.də.vɛ.ˈtəm
agrander	a.gʁã.ˈde
agrarien	a.gʁa.ˈʁi
agresser	a.gʁɛ.ˈse
agressif	a.gʁɛ.ˈsif
agression	a.gʁɛ.ˈsjõ
agriculteur	a.gʁi.kyl.ˈtœʁ
agriculture	a.gʁi.kyl.ˈtyʁ
agripper	a.gʁi.ˈpe
agronome	a.gʁo.ˈnɔm
agronomie	a.gʁo.no.ˈmi
agronomique	a.gʁo.nɔ.ˈmik
agréable	a.ˈgʁeabl
agréablement	a.gʁea.ˈbləm
agréer	a.ˈgʁee
agrégat	a.gʁe.ˈga
agrément	a.ˈgʁem
ah	a
aide	ɛd
aider	ɛ.ˈde
aigle	ɛgl
aiglefin	ɛ.glə.ˈfɛ̃
aiglon	ɛ.ˈglõ
aigre	ɛgʁ
aigreur	ɛ.ˈgʁœʁ
aigrir	ɛ.ˈgʁiʁ
aigu	ɛ.ˈgy
aiguille	ɛg.ˈɥij
aiguiller	ɛg.ɥi.ˈje
aiguille de montre	ɛg.ɥij.də.ˈmõtʁ
aiguille à coudre	ɛg.ɥi.ja.ˈkudʁ
aiguiser	ɛ.gi.ˈze
aile	ɛl
ailleurs	a.ˈjœʁ
aimable	ɛ.ˈmabl
aimer	ɛ.ˈme
aimer mieux	ɛ.me.ˈmjø
aine	ɛn
ainsi	ɛ̃.ˈsi
air	ɛʁ
airain	ɛ.ˈʁɛ̃
aire	ɛʁ
air de musique	ɛʁ.də.my.ˈzik
aisselle	ɛ.ˈsɛl
aisé	ɛ.ˈze
ajourner	a.ʒuʁ.ˈne
ajouter	a.ʒu.ˈte
ajuster	a.ʒy.ˈste
alarme	a.ˈlaʁm
alarmer	a.laʁ.ˈme
albanais	al.ba.ˈnɛ
albatros	al.ba.ˈtʁo
albino	al.bi.ˈno
album	al.ˈbɔm
albumen	al.by.ˈmɛn
alcali	al.ka.ˈli
alcalin	al.ka.ˈlɛ̃
alchimie	al.ʃi.ˈmi
alchimiste	al.ʃi.ˈmist
alcool	al.ˈkɔl
alcoolique	al.kɔ.ˈlik
alcoolisme	al.kɔ.ˈlism
alcool dénaturé	al.kɔl.de.na.ty.ˈʁe
alcôve	al.ˈkov
aldéhyde	al.ˈdeid
alentour	a.lã.ˈtuʁ
alentours	a.lã.ˈtuʁ
alerte	a.ˈlɛʁt
alerter	a.lɛʁ.ˈte
algue	alg
algébrique	al.ʒe.ˈbʁik
algérien	al.ʒe.ˈʁi
algèbre	al.ˈʒɛbʁ
alibi	a.li.ˈbi
aliment	a.ˈlim
alimenter	a.li.mã.ˈte
alinéa	a.li.ˈnea
aliénation	a.lje.na.ˈsjõ
aliéniste	a.lje.ˈnist
aliéné	a.lje.ˈne
allaiter	a.lɛ.ˈte
allemand	a.lə.ˈmã
aller	a.ˈle
allergie	a.lɛʁ.ˈʒi
allergique	a.lɛʁ.ˈʒik
aller en pélerinage	a.le.pe.lə.ʁi.ˈnaʒ
aller en véhicule	a.le.vei.ˈkyl
aller à la selle	a.lea.la.ˈsɛl
alliage	a.ˈljaʒ
alliance	a.ˈljãs
allier	a.ˈlje
alligator	a.li.ga.ˈtɔʁ
allitération	a.li.te.ʁa.ˈsjõ
allonger	a.lõ.ˈʒe
allouer	a.ˈlue
allumer	a.ly.ˈme
allumette	a.ly.ˈmɛt
allure	a.ˈlyʁ
alléchant	a.le.ˈʃã
allécher	a.le.ˈʃe
allée	a.ˈle
allégorie	a.le.gɔ.ˈʁi
allégorique	a.le.gɔ.ˈʁik
allégresse	a.le.ˈgʁɛs
allô	a.ˈlo
almanach	al.ma.ˈna
alors	a.ˈlɔʁ
alouette	a.ˈlwɛt
aloès	a.ˈloɛs
alpaga	al.pa.ˈga
alpestre	al.ˈpɛstʁ
alpha	al.ˈfa
alphabet	al.fa.ˈbɛ
alphabétique	al.fa.bɛ.ˈtik
alpin	al.ˈpɛ̃
alpinisme	al.pi.ˈnism
alpiniste	al.pi.ˈnist
alsacien	al.sa.ˈsi
alternative	al.tɛʁ.na.ˈtiv
alterner	al.tɛʁ.ˈne
altier	al.ˈtje
altitude	al.ti.ˈtyd
alto	al.ˈto
altruisme	al.ˈtʁɥism
altruiste	al.ˈtʁɥist
aluminium	a.ly.mi.ˈnjɔm
alun	a.ˈly
aléa	a.ˈlea
aléatoire	a.lea.ˈtwaʁ
amabilité	a.ma.bi.li.ˈte
amadouer	a.ma.ˈdue
amande	a.ˈmãd
amant	a.ˈmã
amante	a.ˈmãt
amarante	a.ma.ˈʁãt
amas	a.ˈma
amateur	a.ma.ˈtœʁ
amazone	a.ma.ˈzɔn
ambassade	ã.ba.ˈsad
ambassadeur	ã.ba.sa.ˈdœʁ
ambassadrice	ã.ba.sa.ˈdʁis
ambiance	ã.ˈbjãs
ambigu	ã.bi.ˈgy
ambitieux	ã.bi.ˈsjø
ambition	ã.bi.ˈsjõ
ambivalence	ã.bi.va.ˈlãs
ambre	ãbʁ
ambre gris	ãbʁ.ˈgʁi
ambre jaune	ãbʁ.ˈʒon
ambroisie	ã.bʁwa.ˈzi
ambulance	ã.by.ˈlãs
amende	a.ˈmãd
amender	a.mã.ˈde
amener	a.mə.ˈne
amener à	a.mə.ˈnea
amer	a.ˈme
ami	a.ˈmi
amibe	a.ˈmib
amical	a.mi.ˈkal
amie	a.ˈmi
amiral	a.mi.ˈʁal
amitié	a.mi.ˈtje
ami politique	a.mi.pɔ.li.ˈtik
ammoniaque	a.mo.ˈnjak
amnistie	am.ni.ˈsti
amoindrir	a.mwɛ̃.ˈdʁiʁ
amok	a.ˈmɔk
amorphe	a.ˈmɔʁf
amour	a.ˈmuʁ
amoureux	a.mu.ˈʁø
amour charnel	a.muʁ.ʃaʁ.ˈnɛl
amphibie	ã.fi.ˈbi
amphibologique	ã.fi.bɔ.lo.ˈʒik
amphitryon	ã.fi.ˈtʁjõ
amphitéâtre	ã.fi.ˈteatʁ
amphore	ã.ˈfɔʁ
amphétamine	ã.fɛ.ta.ˈmin
ample	ãpl
ampleur	ã.ˈplœʁ
amplifier	ã.pli.ˈfje
amplitude	ã.pli.ˈtyd
ampoule	ã.ˈpul
amputation	ã.py.ta.ˈsjõ
amputer	ã.py.ˈte
ampère	ã.ˈpɛʁ
amulette	a.my.ˈlɛt
amusant	a.my.ˈzã
amusement	a.my.ˈzəm
amuser	a.my.ˈze
amygdale	a.mi.ˈdal
améliorer	a.me.ljɔ.ˈʁe
aménité	a.me.ni.ˈte
américain	a.me.ʁi.ˈkɛ̃
américaniser	a.me.ʁi.ka.ni.ˈze
améthyste	a.me.ˈtist
amène	a.ˈmɛn
an	ã
anabaptisme	a.na.ba.ˈtism
anachronisme	a.na.kʁo.ˈnism
anaconda	a.na.kõ.ˈda
anagramme	a.na.ˈgʁam
anal	a.ˈnal
analogie	a.na.lo.ˈʒi
analogique	a.na.lo.ˈʒik
analogue	a.na.ˈlɔg
analphabète	a.nal.fa.ˈbɛt
analyse	a.na.ˈliz
analyser	a.na.li.ˈze
analyste	a.na.ˈlist
ananas	a.na.ˈna
anapeste	a.na.ˈpɛst
anar	a.ˈnaʁ
anarchie	a.naʁ.ˈʃi
anarchique	a.naʁ.ˈʃik
anarchisme	a.naʁ.ˈʃism
anarchiste	a.naʁ.ˈʃist
anathème	a.na.ˈtɛm
anatomie	a.na.to.ˈmi
anatomique	a.na.to.ˈmik
anatomiste	a.na.to.ˈmist
anchois	ã.ˈʃwa
ancien	ã.ˈsi
ancolie	ã.kɔ.ˈli
ancre	ãkʁ
ancêtre	ã.ˈsɛtʁ
andalou	ã.da.ˈlu
andorran	ã.dɔ.ˈʁã
andouille	ã.ˈduj
anecdote	a.nɛk.ˈdɔt
anecdotique	a.nɛk.dɔ.ˈtik
anesthésie	a.nɛ.ste.ˈzi
anesthésiste	a.nɛ.ste.ˈzist
ange	ãʒ
angine	ã.ˈʒin
anglais	ã.ˈglɛ
angle	ãgl
anglican	ã.gli.ˈkã
anglicisme	ã.gli.ˈsism
angoisse	ãg.ˈwas
angolais	ã.gɔ.ˈlɛ
anguille	ã.ˈgij
anguillule	ãg.ˈjyl
angulaire	ã.gy.ˈlɛʁ
anguleux	ã.gy.ˈlø
angélique	ã.ʒe.ˈlik
aniline	a.ni.ˈlin
animal	a.ni.ˈmal
animal domestique	a.ni.mal.do.mɛ.ˈstik
animer	a.ni.ˈme
anneau	a.ˈno
annihilation	a.nii.la.ˈsjõ
anniversaire	a.ni.vɛʁ.ˈsɛʁ
annonce	a.ˈnõs
annoncer	a.nõ.ˈse
annuaire	a.ˈnyɛʁ
annuel	a.ˈnyɛl
annuellement	a.nyɛ.ˈləm
annulation	a.ny.la.ˈsjõ
annuler	a.ny.ˈle
année	a.ˈne
année financière	a.ne.fi.nã.ˈsjɛʁ
anode	a.ˈnɔd
anonymat	a.no.ni.ˈma
anonyme	a.no.ˈnim
anormal	a.nɔʁ.ˈmal
antagoniste	ã.ta.go.ˈnist
antarctique	ã.taʁk.ˈtik
antenne	ã.ˈtɛn
anthologie	ã.to.lo.ˈʒi
anthracite	ã.tʁa.ˈsit
anthropologie	ã.tʁɔ.pɔ.lo.ˈʒi
anthropologiste	ã.tʁɔ.pɔ.lo.ˈʒist
anthropologue	ã.tʁɔ.pɔ.ˈlog
antibiotique	ã.ti.bjo.ˈtik
antichambre	ã.ti.ˈʃãbʁ
anticipation	ã.ti.si.pa.ˈsjõ
anticiper	ã.ti.si.ˈpe
anticorps	ã.ti.ˈkɔʁ
antidote	ã.ti.ˈdɔt
antigel	ã.ti.ˈʒɛl
antillais	ã.ti.ˈjɛ
antilope	ã.ti.ˈlɔp
antimoine	ã.ti.ˈmwan
antipathie	ã.ti.pa.ˈti
antipathique	ã.ti.pa.ˈtik
antipode	ã.ti.ˈpɔd
antique	ã.ˈtik
antiseptique	ã.ti.zɛp.ˈtik
antisocial	ã.ti.zo.ˈsjal
antisémite	ã.ti.se.ˈmit
antisémitique	ã.ti.se.mi.ˈtik
antisémitisme	ã.ti.se.mi.ˈtism
antithèse	ã.ti.ˈtɛz
antéchrist	ã.tɛʃ.ˈʁist
antécédent	ã.te.ˈsed
anus	a.ˈnys
anversois	ã.vɛʁ.ˈswa
anxiété	ãk.sje.ˈte
anémie	a.ne.ˈmi
anémique	a.ne.ˈmik
anémone	a.ne.ˈmɔn
aorta	aɔʁ.ˈta
août	ut
apache	a.ˈpaʃ
apartheid	a.paʁ.ˈtɛd
apathie	a.pa.ˈti
apathique	a.pa.ˈtik
apercevoir	a.pɛʁ.sə.ˈvwaʁ
apesanteur	a.pə.zã.ˈtœʁ
aphasie	a.fa.ˈzi
aphorisme	a.fɔ.ˈʁism
apiculteur	a.pi.kyl.ˈtœʁ
apiculture	a.pi.kyl.ˈtyʁ
apitoiement	a.pi.ˈtwam
apitoyer	a.pi.twa.ˈje
aplati	a.pla.ˈti
aplomb	a.ˈplõ
apocalyptique	a.po.ka.lip.ˈtik
apocryphe	a.po.ˈkʁif
apogée	a.pɔ.ˈʒe
apologie	a.pɔ.lo.ˈʒi
apoplexie	a.po.plɛk.ˈsi
apostat	a.po.ˈsta
apostolat	a.po.stɔ.ˈla
apostolique	a.po.stɔ.ˈlik
apostrophe	a.po.ˈstʁɔf
apothicaire	a.po.ti.ˈkɛʁ
apothéose	a.pɔ.ˈteoz
apparant	a.pa.ˈʁã
apparaître	a.pa.ˈʁɛtʁ
appareil	a.pa.ˈʁɛj
appareil administratif	a.pa.ʁɛ.jad.mi.ni.stʁa.ˈtif
apparemment	a.pa.ˈʁam
apparence	a.pa.ˈʁãs
apparier	a.pa.ˈʁje
apparition	a.pa.ʁi.ˈsjõ
appartement	a.paʁ.ˈtəm
appartenir	a.paʁ.tə.ˈniʁ
appeler	a.pə.ˈle
appendice	a.pã.ˈdis
appendicite	a.pã.di.ˈsit
applaudir	a.plo.ˈdiʁ
application	a.pli.ka.ˈsjõ
appliquer	a.pli.ˈke
appliqué	a.pli.ˈke
appointements	a.pwɛ̃.ˈtəm
apporter	a.pɔʁ.ˈte
apposer	a.po.ˈze
apprendre	a.ˈpʁãdʁ
apprendre par l'expérience	a.pʁãdʁ.paʁ.lɛk.spe.ˈʁjãs
apprendre à	a.pʁã.ˈdʁa
apprendre à fond	a.pʁã.dʁa.ˈfõ
appris	a.ˈpʁi
apprivoiser	a.pʁi.vwa.ˈze
apprivoisé	a.pʁi.vwa.ˈze
approbation	a.pʁɔ.ba.ˈsjõ
approche	a.ˈpʁɔʃ
approcher	a.pʁɔ.ˈʃe
approuver	a.pʁu.ˈve
apprécier	a.pʁe.ˈsje
appréhension	a.pʁeã.ˈsjõ
apprêter	a.pʁɛ.ˈte
appui	a.ˈpɥi
appuyer	a.pɥi.ˈje
appuyer en écrasant	a.pɥi.jee.kʁa.ˈzã
appétit	a.pɛ.ˈti
appât	a.ˈpa
appâter	a.pa.ˈte
après	a.ˈpʁɛ
apte à	ap.ˈta
aptitude	ap.ti.ˈtyd
apéritif	a.pe.ʁi.ˈtif
apéro	a.pe.ˈʁo
apôtre	a.ˈpotʁ
aquarelle	a.kwa.ˈʁɛl
aquarium	a.kwa.ˈʁjɔm
aquatique	a.kwa.ˈtik
aqueduc	ak.ˈdyk
arabe	a.ˈʁab
arabesque	a.ʁa.ˈbɛsk
arabique	a.ʁa.ˈbik
arachide	a.ʁa.ˈʃid
arack	a.ˈʁak
araignée	a.ʁɛ.ˈnje
arbitraire	aʁ.bi.ˈtʁɛʁ
arbitre	aʁ.ˈbitʁ
arbouse	aʁ.ˈbuz
arbousier	aʁ.buz.ˈje
arbre	aʁbʁ
arbre de transmission	aʁbʁ.də.tʁã.smi.ˈsjõ
arbrisseau	aʁ.bʁi.ˈso
arbuste	aʁ.ˈbyst
arc	aʁk
arcane	aʁ.ˈkan
archange	aʁ.ˈʃãʒ
archaïsme	aʁ.ˈkaism
archevêque	aʁ.ʃə.ˈvɛk
archiduc	aʁ.ʃi.ˈdyk
archiduché	aʁ.ʃi.dy.ˈʃe
archipel	aʁ.ʃi.ˈpɛl
architecte	aʁ.ʃi.ˈtɛkt
architectonique	aʁ.ʃi.tɛk.to.ˈnik
architectural	aʁ.ʃi.tɛk.ty.ˈʁal
architecture	aʁ.ʃi.tɛk.ˈtyʁ
archiviste	aʁ.ʃi.ˈvist
archéologie	aʁ.keɔ.lɔ.ˈʒi
archéologique	aʁ.keɔ.lo.ˈʒik
archéologue	aʁ.keɔ.ˈlɔg
arctique	aʁk.ˈtik
ardant	aʁ.ˈdã
ardeur	aʁ.ˈdœʁ
are	aʁ
argent	aʁʒ
argentin	aʁ.ʒã.ˈtɛ̃
argile	aʁ.ˈʒil
argon	aʁ.ˈgõ
argument	aʁ.ˈgym
aria	a.ˈʁja
aristo	a.ʁi.ˈsto
aristocrate	a.ʁi.sto.ˈkʁat
aristocratie	a.ʁi.sto.kʁa.ˈsi
aristocratique	a.ʁi.sto.kʁa.ˈtik
arithmétique	a.ʁit.mɛ.ˈtik
arlequin	aʁ.lə.ˈkɛ̃
arme	aʁm
armer	aʁ.ˈme
armoire	aʁ.ˈmwaʁ
armure	aʁ.ˈmyʁ
armée	aʁ.ˈme
armée militaire	aʁ.me.mi.li.ˈtɛʁ
arménien	aʁ.me.ˈni
arnica	aʁ.ni.ˈka
aromatique	a.ʁo.ma.ˈtik
aronde	a.ˈʁõd
arracher	a.ʁa.ˈʃe
arrangement	a.ʁã.ˈʒəm
arranger	a.ʁã.ˈʒe
arrestation	a.ʁɛ.sta.ˈsjõ
arrimer	a.ʁi.ˈme
arrimeur	a.ʁi.ˈmœʁ
arrivage	a.ʁi.ˈvaʒ
arriver	a.ʁi.ˈve
arriver en flottant	a.ʁi.ve.flɔ.ˈtã
arrivée	a.ʁi.ˈve
arrière	a.ˈʁjɛʁ
arrogant	a.ʁo.ˈgã
arrondir	a.ʁõ.ˈdiʁ
arrondissement	a.ʁõ.di.ˈsəm
arroser	a.ʁo.ˈze
arrosoir	a.ʁoz.ˈwaʁ
arrêt	a.ˈʁɛ
arrêter	a.ʁɛ.ˈte
arsenal	aʁ.sə.ˈnal
arsenic	aʁ.sə.ˈnik
art	aʁ
arthrite	aʁ.ˈtʁit
artichaut	aʁ.ti.ˈʃo
article	aʁ.ˈtikl
articulation	aʁ.ti.ky.la.ˈsjõ
artifice	aʁ.ti.ˈfis
artificiel	aʁ.ti.fi.ˈsjɛl
artificieux	aʁ.ti.fi.ˈsjø
artillerie	aʁ.ti.jə.ˈʁi
artilleur	aʁ.ˈtjœʁ
artisan	aʁ.ti.ˈzã
artiste	aʁ.ˈtist
artériosclérose	aʁ.te.ʁjo.skle.ˈʁoz
artésien	aʁ.te.ˈzi
artère	aʁ.ˈtɛʁ
arum	a.ˈʁɔm
aryen	aʁj
arène	a.ˈʁɛn
arête	a.ˈʁɛt
arôme	a.ˈʁom
as	a
asbeste	as.ˈbɛst
ascenseur	a.sã.ˈsœʁ
asile	a.ˈzil
aspect	a.ˈspɛ
asperge	a.ˈspɛʁʒ
asphalte	a.ˈsfalt
asphalter	a.sfal.ˈte
asphodèle	a.sfo.ˈdɛl
aspirateur	a.spi.ʁa.ˈtœʁ
aspirer	a.spi.ˈʁe
aspirer à	a.spi.ˈʁea
aspirine	a.spi.ˈʁin
assaillir	a.sa.ˈjiʁ
assainir	a.sɛ.ˈniʁ
assaisonner	a.sɛ.zɔ.ˈne
assassiner	a.sa.si.ˈne
assaut	a.ˈso
assembler	a.sã.ˈble
assemblée	a.sã.ˈble
assemblée politique	a.sã.ble.pɔ.li.ˈtik
asseoir	a.ˈswaʁ
assertion	a.sɛʁ.ˈtjõ
assez	a.ˈse
assidu	a.si.ˈdy
assiette	a.ˈsjɛt
assigner	a.si.ˈnje
assimilation	a.si.mi.la.ˈsjõ
assimiler	a.si.mi.ˈle
assister	a.si.ˈste
assister à	a.si.ˈstea
assièger	a.sjɛ.ˈʒe
association	a.so.sja.ˈsjõ
associer	a.so.ˈsje
assoupir	a.su.ˈpiʁ
assurance	a.sy.ˈʁãs
assurer	a.sy.ˈʁe
assureur	a.sy.ˈʁœʁ
assuré	a.sy.ˈʁe
assurément	a.sy.ˈʁem
assyrien	as.sɛ̃.ˈʁi
aster	a.ˈste
asthmatique	a.sma.ˈtik
asthme	asm
astral	a.ˈstʁal
astre	astʁ
astrologie	a.stʁɔ.lo.ˈʒi
astrologue	a.stʁɔ.ˈlɔg
astronaute	a.stʁo.ˈnot
astronome	a.stʁo.ˈnɔm
astronomie	a.stʁo.no.ˈmi
astronomique	a.stʁo.nɔ.ˈmik
astucieux	a.sty.ˈsjø
astérisque	a.ste.ˈʁisk
astéroïde	a.ste.ˈʁoid
asymétrique	a.si.me.ˈtʁik
atavisme	a.ta.ˈvism
atelier	a.tə.ˈlje
athlétique	at.lɛ.ˈtik
athlétisme	at.lɛ.ˈtism
athlète	at.ˈlɛt
athée	a.ˈte
athéisme	a.ˈteism
athénien	a.te.ˈni
atlantique	at.lã.ˈtik
atmosphère	at.mo.ˈsfɛʁ
atmosphèrique	at.mo.sfɛ.ˈʁik
atoll	a.ˈtɔl
atome	a.ˈtom
atomique	a.to.ˈmik
atout	a.ˈtu
atroce	a.ˈtʁɔs
atrocité	a.tʁɔ.si.ˈte
atrophie	a.tʁo.ˈfi
attachant	a.ta.ˈʃã
attachement	a.ta.ˈʃəm
attacher	a.ta.ˈʃe
attaché	a.ta.ˈʃe
attaquant	a.ta.ˈkã
attaque	a.ˈtak
attaquer	a.ta.ˈke
atteindre	a.ˈtɛ̃dʁ
atteler	a.tə.ˈle
attendre	a.ˈtãdʁ
attendrissant	a.tã.dʁi.ˈsã
attendu que	a.tã.dy.ˈkə
attentat	a.tã.ˈta
attente	a.ˈtãt
attenter	a.tã.ˈte
attentif	a.tã.ˈtif
attention	a.tã.ˈtjõ
attentivement	a.tã.ˈtivm
atterrir	a.tɛ.ˈʁiʁ
attester	a.tɛ.ˈste
attirant	a.ti.ˈʁã
attirer	a.ti.ˈʁe
attitude	a.ti.ˈtyd
attraper	a.tʁa.ˈpe
attrayant	a.tʁɛ.ˈjã
attribuer	a.tʁi.ˈbye
attribut	a.tʁi.ˈby
attrister	a.tʁi.ˈste
au	o
aubade	o.ˈbad
aube	ob
auberge	o.ˈbɛʁʒ
aubergiste	o.bɛʁ.ˈʒist
audace	o.ˈdas
audacieux	o.da.ˈsjø
audience	o.ˈdjãs
auditeur	o.di.ˈtœʁ
auditoire	o.di.ˈtwaʁ
auditorium	o.di.to.ˈʁiɔm
auge	oʒ
augmenter	og.mã.ˈte
augure	o.ˈgyʁ
augurer	o.gy.ˈʁe
aujourd'hui	o.ʒuʁ.ˈdɥi
aulne	oln
aumône	o.ˈmon
aumônier	o.mo.ˈnje
auparavant	o.pa.ʁa.ˈvã
auprès	o.ˈpʁɛ
auquel	o.ˈkɛl
aura	o.ˈʁa
aurochs	o.ˈʁoʃ
aurore	o.ˈʁɔʁ
auréole	o.ˈʁeɔl
aussi	o.ˈsi
aussitôt	o.si.ˈto
austral	o.ˈstʁal
australien	o.stʁa.ˈli
austérité	o.ste.ʁi.ˈte
austère	o.ˈstɛʁ
autant	o.ˈtã
autarcie	o.taʁ.ˈsi
autel	o.ˈtɛl
auteur	o.ˈtœʁ
authentique	o.tã.ˈtik
autisme	o.ˈtism
autistique	o.ti.ˈstik
auto	o.ˈto
autobiographie	o.tɔ.bjɔ.gʁa.ˈfi
autobiographique	o.tɔ.bjɔ.gʁa.ˈfik
autobus	o.tɔ.ˈbys
autochtone	o.tɔk.ˈtɔn
autocrate	o.to.ˈkʁat
autocratie	o.to.kʁa.ˈsi
autocratique	o.to.kʁa.ˈtik
autodidacte	o.to.di.ˈdakt
autogène	o.to.ˈʒɛn
automate	o.to.ˈmat
automatique	o.to.ma.ˈtik
automatiquement	o.to.ma.ti.ˈkəm
automatiser	o.to.ma.ti.ˈze
automnal	o.tɔ.ˈnal
automne	o.ˈtɔn
automobilisme	o.tɔ.mɔ.bi.ˈlism
automobiliste	o.tɔ.mɔ.bi.ˈlist
autonome	o.to.ˈnɔm
autonomie	o.to.no.ˈmi
autopsie	o.to.ˈpsi
autorisation	o.to.ʁi.za.ˈsjõ
autoriser	o.to.ʁi.ˈze
autoritaire	o.to.ʁi.ˈtɛʁ
autorité	o.to.ʁi.ˈte
autoroute	o.to.ˈʁut
autostrade	o.to.ˈstʁad
autour	o.ˈtuʁ
autour de	o.tuʁ.ˈdə
autre	otʁ
autrefois	o.tʁə.ˈfwa
autrement	o.ˈtʁəm
autrichien	o.tʁi.ˈʃi
autruche	o.ˈtʁyʃ
autrui	o.ˈtʁɥi
aux	o
auxiliaire	ok.si.ˈljɛʁ
aux bords de	o.bɔʁ.ˈdə
au bord de	o.bɔʁ.ˈdə
au commencement	o.kɔ.mã.ˈsəm
au lieu de	o.ljø.ˈdə
au milieu de	o.mi.ljø.ˈdə
au milie de	o.mi.li.ˈdə
au moins	o.ˈmwɛ̃
au moyen de	o.mwaj.ˈdə
au repos	o.ʁə.ˈpo
au revoir	o.ʁə.ˈvwaʁ
au sujet de	o.sy.ʒɛ.ˈdə
avalanche	a.va.ˈlãʃ
avaler	a.va.ˈle
avancement	a.vã.ˈsəm
avancer	a.vã.ˈse
avant	a.ˈvã
avantage	a.vã.ˈtaʒ
avantageux	a.vã.ta.ˈʒø
avare	a.ˈvaʁ
avarice	a.va.ˈʁis
avaricieux	a.va.ʁi.ˈsjø
avarie	a.va.ˈʁi
avec	a.ˈvɛk
avenir	a.və.ˈniʁ
avent	av
aventure	a.vã.ˈtyʁ
aventurer	a.vã.ty.ˈʁe
avenue	a.və.ˈny
aversion	a.vɛʁ.ˈsjõ
avertir	a.vɛʁ.ˈtiʁ
avertisseur	a.vɛʁ.ti.ˈsœʁ
aveu	a.ˈvø
aveugle	a.ˈvœgl
aveugler	a.vœ.ˈgle
aviateur	a.vja.ˈtœʁ
aviation	a.vja.ˈsjõ
avide	a.ˈvid
avidité	a.vi.di.ˈte
avion	a.ˈvjõ
avion à réaction	a.vjõa.ʁeak.ˈsjõ
aviron	a.vi.ˈʁõ
avis	a.ˈvi
avisé	a.vi.ˈze
avocat	a.vo.ˈka
avocat conseil	a.vo.ka.kõ.ˈsɛj
avoine	a.ˈvwan
avoir	a.ˈvwaʁ
avoir besoin de	a.vwaʁ.bəz.wɛ̃.ˈdə
avoir coutume	a.vwaʁ.ku.ˈtym
avoir en abomination	a.vwa.ʁa.bo.mi.na.ˈsjõ
avoir faim	a.vwaʁ.ˈfɛ̃
avoir honte	a.vwa.ˈʁõt
avoir le hoquet	a.vwaʁ.ləɔ.ˈkɛ
avoir lieu	a.vwaʁ.ˈljø
avoir l'air de	a.vwaʁ.lɛʁ.ˈdə
avoir l'habitude de	a.vwaʁ.la.bi.tyd.ˈdə
avoir peur	a.vwaʁ.ˈpœʁ
avoir pitié	a.vwaʁ.pi.ˈtje
avoir pour but	a.vwaʁ.puʁ.ˈbyt
avoir soif	a.vwaʁ.ˈswaf
avoir soin de	a.vwaʁ.swɛ̃.ˈdə
avoir une dette	a.vwa.ʁyn.ˈdɛt
avoir un accident	a.vwa.ʁœ̃ak.ˈsid
avortement	a.vɔʁ.ˈtəm
avortement provoqué	a.vɔʁ.təm.pʁo.vɔ.ˈke
avortement spontané	a.vɔʁ.təm.spõ.ta.ˈne
avorter	a.vɔʁ.ˈte
avorteur	a.vɔʁ.ˈtœʁ
avouer	a.ˈvue
avril	a.ˈvʁil
axe	aks
axiome	ak.ˈsjom
ayant le mal de l'air	ɛ.jã.lə.mal.də.ˈlɛʁ
azalée	a.za.ˈle
azimut	a.zi.ˈmy
azote	a.ˈzɔt
aztèque	az.ˈtɛk
azur	a.ˈzyʁ
aïe	aj
aïeul	a.ˈjœl
aïeule	a.ˈjœl
aérateur	ae.ʁa.ˈtœʁ
aérer	ae.ˈʁe
aérien	ae.ˈʁi
aérodrome	ae.ʁɔ.ˈdʁɔm
aérodynamique	ae.ʁɔ.di.na.ˈmik
aérogramme	ae.ʁo.ˈgʁam
aérolithe	ae.ʁɔ.ˈlit
aéronaute	ae.ʁo.ˈnot
aéronautique	ae.ʁo.no.ˈtik
aéronef	ae.ʁo.ˈnɛf
aéroplane	ae.ʁo.ˈplan
aéroport	ae.ʁɔ.ˈpɔʁ
aérosol	ae.ʁɔ.ˈsɔl
aérostat	ae.ʁo.ˈsta
babil	ba.ˈbil
babilage	ba.bi.ˈlaʒ
babillard	ba.bi.ˈjaʁ
babiller	ba.bi.ˈje
babiole	ba.ˈbjɔl
babouin	ba.ˈbwɛ̃
babylonien	ba.bi.lo.ˈni
bac	bak
baccalauréat	ba.ka.lɔ.ˈʁea
bactérie	bak.te.ˈʁi
badauder	ba.do.ˈde
badinage	ba.di.ˈnaʒ
badine	ba.ˈdin
badiner	ba.di.ˈne
bafouer	ba.ˈfue
bafouiller	ba.fu.ˈje
bagage	ba.ˈgaʒ
bagagiste	ba.ga.ˈʒist
bagarre	ba.ˈgaʁ
bagarreur	ba.ga.ˈʁœʁ
bagasse	ba.ˈgas
bagatelle	ba.ga.ˈtɛl
bagnole	ba.ˈnjɔl
bague	bag
baguette	ba.ˈgɛt
bai	bɛ
baie	bɛ
baie Chiyask	bɛ.ˈʃiask
baie Georgienne	bɛ.ʒɔʁʒ.ˈjɛn
baie James	bɛ.ˈʒam
baie chez Lepage	bɛ.ʃe.lə.ˈpaʒ
baie des Chaleurs	bɛ.de.ʃa.ˈlœʁ
baie de Baffin	bɛ.də.ba.ˈfɛ̃
baie de Fundy	bɛ.də.fy.ˈdi
baie d'Hudson	bɛ.dy.ˈsõ
baie d'Ungava	bɛ.dy.ga.ˈva
baigner	bɛ.ˈnje
baignoire	bɛnj.ˈwaʁ
bail	baj
bailler	ba.ˈje
bailli	ba.ˈji
bain	bɛ̃
baiser	bɛ.ˈze
baisser	bɛ.ˈse
bakélite	ba.ke.ˈlit
bal	bal
baladeuse	ba.la.ˈdøz
baladin	ba.la.ˈdɛ̃
balafre	ba.ˈlafʁ
balai	ba.ˈlɛ
balalaïka	ba.la.lai.ˈka
balance	ba.ˈlãs
balancer	ba.lã.ˈse
balayer	ba.lɛ.ˈje
balbutier	bal.by.ˈtje
balcon	bal.ˈkõ
baldaquin	bal.da.ˈkɛ̃
baleine	ba.ˈlɛn
balinais	ba.li.ˈnɛ
balise	ba.ˈliz
balistique	ba.li.ˈstik
ballade	ba.ˈlad
ballast	ba.ˈlast
balle	bal
ballerine	ba.lə.ˈʁin
ballet	ba.ˈlɛ
balle de fusil	bal.də.fy.ˈzi
ballon	ba.ˈlõ
ballon de football	ba.lõ.də.fut.ˈbol
balsamine	bal.sa.ˈmin
balte	balt
balustrade	ba.ly.ˈstʁad
bambou	bã.ˈbu
bamboucher	bã.bu.ˈʃe
banal	ba.ˈnal
banane	ba.ˈnan
bananier	ba.na.ˈnje
banc	bã
bandage	bã.ˈdaʒ
bande	bãd
bandeau	bã.ˈdo
bander	bã.ˈde
banderole	bã.də.ˈʁɔl
bande vidéo	bãd.vi.ˈdeo
bandit	bã.ˈdi
banian	ba.ˈniã
banjo	bã.ˈʒo
banni	ba.ˈni
bannir	ba.ˈniʁ
bannissement	ba.ni.ˈsəm
banque	bãk
banqueroute	bã.kə.ˈʁut
banquet	bã.ˈkɛ
banqueter	bã.kə.ˈte
banquette	bã.ˈkɛt
banquier	bã.ˈkje
bantou	bã.ˈtu
baobab	bao.ˈbab
baptiser	ba.ti.ˈze
baptiste	ba.ˈtist
baptistère	ba.ti.ˈstɛʁ
baptême	ba.ˈtɛm
baquet	ba.ˈkɛ
bar	baʁ
baraque	ba.ˈʁak
baratter	ba.ʁa.ˈte
barbare	baʁ.ˈbaʁ
barbaresque	baʁ.ba.ˈʁɛsk
barbarie	baʁ.ba.ˈʁi
barbarisme	baʁ.ba.ˈʁism
barbe	baʁb
barbeau	baʁ.ˈbo
barbier	baʁ.ˈbje
barboter	baʁ.bɔ.ˈte
barbu	baʁ.ˈby
barbue	baʁ.ˈby
bardane	baʁ.ˈdan
barde	baʁd
bardot	baʁ.ˈdo
barge	baʁʒ
barguigner	baʁ.gi.ˈnje
barman	baʁ.ˈman
baromètre	ba.ʁo.ˈmɛtʁ
baron	ba.ˈʁõ
baronne	ba.ˈʁɔn
baronnie	ba.ʁɔ.ˈni
baroque	ba.ˈʁɔk
baroud	ba.ˈʁu
barouf	ba.ˈʁuf
baroufle	ba.ˈʁufl
barque	baʁk
barquette	baʁ.ˈkɛt
barre	baʁ
barreau	ba.ˈʁo
barrer	ba.ˈʁe
barricade	ba.ʁi.ˈkad
barricader	ba.ʁi.ka.ˈde
barrière	ba.ˈʁjɛʁ
baryton	ba.ʁi.ˈtõ
baryum	ba.ˈʁiym
bas	ba
basalte	ba.ˈzalt
bascule	ba.ˈskyl
baser	ba.ˈze
basilic	ba.zi.ˈlik
basilique	ba.zi.ˈlik
basique	ba.ˈzik
basque	bask
bassin	ba.ˈsɛ̃
bassine	ba.ˈsin
bastille	ba.ˈstij
bastion	bast.ˈjõ
bataille	ba.ˈtaj
batailler	ba.ta.ˈje
batailleur	ba.ta.ˈjœʁ
batave	ba.ˈtav
bateau	ba.ˈto
bath	bat
batifoler	ba.ti.fɔ.ˈle
batiker	ba.ti.ˈke
batiste	ba.ˈtist
batterie	ba.tə.ˈʁi
battre	batʁ
baudet	bo.ˈdɛ
baume	bom
bauxite	bok.ˈsit
bavard	ba.ˈvaʁ
bavardage	ba.vaʁ.ˈdaʒ
bavarder	ba.vaʁ.ˈde
bavarois	ba.va.ˈʁwa
bave	bav
baver	ba.ˈve
bayer aux corneilles	bɛ.jeo.kɔʁ.ˈnɛj
bazar	ba.ˈzaʁ
bazooka	ba.zu.ˈka
baïonnette	ba.jɔ.ˈnɛt
beau	bo
beaucoup	bo.ˈku
beaucoup de	bo.ku.ˈdə
beauté	bo.ˈte
bec	bɛk
beige	bɛʒ
belette	bə.ˈlɛt
belge	bɛlʒ
belladone	bɛ.la.ˈdɔn
bengali	bã.ga.ˈli
benzène	bɛ̃.ˈzɛn
berce	bɛʁs
bercer	bɛʁ.ˈse
berlinois	bɛʁ.li.ˈnwa
bernois	bɛʁ.ˈnwa
besoin d'activité	bəz.wɛ̃.dak.ti.vi.ˈte
betterave	bɛ.tə.ˈʁav
beurre	bœʁ
biberon	bi.bə.ˈʁõ
bibliothèque	bibl.jo.ˈtɛk
biche	biʃ
bicyclette	bi.si.ˈklɛt
bien	bi
bientôt	bjɛ̃.ˈto
bienvenue	bjɛ̃.və.ˈny
bien entendu	biã.tã.ˈdy
bien sûr	bi.ˈsyʁ
biffer	bi.ˈfe
bifteck	bif.ˈtɛk
bigarré	bi.ga.ˈʁe
bijou	bi.ˈʒu
bijoutier	bi.ʒu.ˈtje
bikini	bi.ki.ˈni
bile	bil
billet	bi.ˈjɛ
birman	biʁ.ˈman
biscuit	bisk.ˈɥi
bison	bi.ˈzõ
bitte	bit
bizarre	bi.ˈzaʁ
bière	bjɛʁ
blague	blag
blanc	blã
blasphémer	bla.sfe.ˈme
blatte	blat
blesser	blɛ.ˈse
blessure	blɛ.ˈsyʁ
blessé	blɛ.ˈse
bleu	blø
bleuet	bløɛ
bloc	blɔk
blond	blõ
blouse	bluz
blouse longue	bluz.ˈlõg
boa	boa
bobine	bo.ˈbin
bohémien	boe.ˈmi
boire	bwaʁ
bois	bwa
boisson	bwa.ˈsõ
boiteux	bwa.ˈtø
boite à echo	bwa.taə.ˈko
bol	bɔl
bolivien	bɔ.li.ˈvi
bombarder	bõ.baʁ.ˈde
bombe	bõb
bombe atomique	bõ.ba.to.ˈmik
bombe à incendie	bõ.baɛ̃.sã.ˈdi
bon	bõ
bonbon	bõ.ˈbõ
bonjour	bõ.ˈʒuʁ
bonnet	bo.ˈnɛ
bonne nuit	bɔn.ˈnɥi
bonsoir	bõ.ˈswaʁ
bord	bɔʁ
bordel	bɔʁ.ˈdɛl
bosniaque	bosn.ˈjak
bosnien	bo.ˈsni
bosse	bos
bossu	bo.ˈsy
botte	bɔt
bouc	buk
bouche	buʃ
boucher	bu.ˈʃe
boucherie	bu.ʃə.ˈʁi
bouchon	bu.ˈʃõ
bouchon de liège	bu.ʃõ.də.ˈljɛʒ
boucler	bu.ˈkle
boucle de vêtement	bukl.də.vɛ.ˈtəm
bouddhisme	bu.ˈdism
bouddhiste	bu.ˈdist
bouder	bu.ˈde
boue	bu
bougie	bu.ˈʒi
bougie électrique	bu.ʒie.lɛk.ˈtʁik
bougnoul	bu.ˈnjul
bouillie	bu.ˈji
bouillir	bu.ˈjiʁ
bouillon	bu.ˈjõ
boulanger	bu.lã.ˈʒe
boulangerie	bu.lã.ʒə.ˈʁi
boule	bul
bouleau	bu.ˈlo
boulevard	bu.lə.ˈvaʁ
boulier	bu.ˈlje
bouquet	bu.ˈkɛ
bouquin	bu.ˈkɛ̃
bourdon	buʁ.ˈdõ
bourdonner	buʁ.dɔ.ˈne
bourgeois	buʁ.ˈʒwa
bourse du travail	buʁs.dy.tʁa.ˈvaj
boussole	bu.ˈsɔl
bout	bu
bouteille	bu.ˈtɛj
boutique	bu.ˈtik
bouton	bu.ˈtõ
boxer	bɔk.ˈse
boîte	bwat
boîte aux lettres	bwa.to.ˈlɛtʁ
brabançon	bʁa.bã.ˈsõ
branche	bʁãʃ
branchie	bʁã.ˈʃi
brandir	bʁã.ˈdiʁ
bras	bʁa
braser	bʁa.ˈze
bras supérieur	bʁa.sy.pe.ˈʁjœʁ
brave	bʁav
bretelles	bʁə.ˈtɛl
bride	bʁid
briller	bʁi.ˈje
brique	bʁik
briser	bʁi.ˈze
britannique	bʁi.ta.ˈnik
brochet	bʁo.ˈʃɛ
brochure	bʁo.ˈʃyʁ
broder	bʁɔ.ˈde
brosse	bʁos
brosse à dents	bʁo.ˈsad
brouette	bʁuɛt
brouillard	bʁu.ˈjaʁ
brouiller	bʁu.ˈje
broyer	bʁwa.ˈje
bruine	bʁɥin
brun	bʁœ̃
brusquement	bʁy.ˈskəm
brut	bʁy
bruxellois	bʁyk.sɛ.ˈlwa
bruyère	bʁy.ˈjɛʁ
brésilien	bʁe.zi.ˈli
brèche	bʁɛʃ
brûler	bʁy.ˈle
brûlé	bʁy.ˈle
bubale	by.ˈbal
buffet	by.ˈfɛ
buffle	byfl
bulbe	bylb
bulgare	byl.ˈgaʁ
bulldozer	bul.do.ˈze
bulle	byl
bulletin	by.lə.ˈtɛ̃
bureau	by.ˈʁo
bureau de poste	by.ʁo.də.ˈpɔst
buriner	by.ʁi.ˈne
but	byt
butter	by.ˈte
byte	bit
byzantin	bi.zã.ˈtɛ̃
bébé	be.ˈbe
bébête	be.ˈbɛt
bécane	be.ˈkan
béer	bee
bégayer	be.ge.ˈje
bégonia	be.go.ˈnja
bégueule	be.ˈgøl
béguinage	be.gi.ˈnaʒ
béguine	be.ˈgin
bélier	be.ˈlje
bénir	be.ˈniʁ
bénéfice	be.ne.ˈfis
béryllium	be.ʁi.ˈljɔm
béton	be.ˈtõ
bâbord	ba.ˈbɔʁ
bâillement	ba.ˈjəm
bâiller	ba.ˈje
bâtard	ba.ˈtaʁ
bâtiment	ba.ˈtim
bâtir	ba.ˈtiʁ
bâtisseur	ba.ti.ˈsœʁ
bâton	ba.ˈtõ
bâtonnet	ba.tɔ.ˈnɛ
bêche	bɛʃ
bêler	bɛ.ˈle
bête	bɛt
bûche	byʃ
cabane	ka.ˈban
cabine	ka.ˈbin
cabinet	ka.bi.ˈnɛ
cabinet noir	ka.bi.nɛ.ˈnwaʁ
cabine de bain	ka.bin.də.ˈbɛ̃
cabine de bateau	ka.bin.də.ba.ˈto
cabine téléphonique	ka.bin.te.le.fɔ.ˈnik
cacahouète	ka.ka.ˈwɛt
cacahuète	ka.ˈkayɛt
cacao	ka.ˈkao
cacher	ka.ˈʃe
cachet	ka.ˈʃɛ
cachot	ka.ˈʃo
cactus	kak.ˈtys
cadavre	ka.ˈdavʁ
cadeau	ka.ˈdo
cadre	kadʁ
caduc	ka.ˈdyk
cafard	ka.ˈfaʁ
cafetière	ka.fə.ˈtjɛʁ
café	ka.ˈfe
cage	kaʒ
cahier	ka.ˈje
caille	kaj
caillette	ka.ˈjɛt
caisse	kɛs
calame	ka.ˈlam
calcium	kal.ˈsjɔm
calculer	kal.ky.ˈle
cale	kal
calendrier	ka.lãdʁ.ˈje
calendula	ka.lã.dy.ˈla
caleçon	ka.lə.ˈsõ
californien	ka.li.foʁ.ˈni
calme	kalm
calomnier	ka.lɔm.ˈnje
camarade	ka.ma.ˈʁad
cambodgien	kã.bɔ.ˈʒi
camerounais	ka.mə.ʁu.ˈnɛ
camion	ka.ˈmjõ
camp	kã
campagne	kã.ˈpanj
caméra	ka.me.ˈʁa
canadien	ka.na.ˈdi
canaille	ka.ˈnaj
canal	ka.ˈnal
canapé	ka.na.ˈpe
canard	ka.ˈnaʁ
canard mâle	ka.naʁ.ˈmal
canari	ka.na.ˈʁi
cancaner	kã.ka.ˈne
cancer	kã.ˈse
candidat	kã.di.ˈda
canne	kan
cannelure	ka.nə.ˈlyʁ
canon	ka.ˈnõ
caoutchouc	kau.ˈtʃu
cap	kap
capable	ka.ˈpabl
capacité	ka.pa.si.ˈte
capitaine	ka.pi.ˈtɛn
capital	ka.pi.ˈtal
capote	ka.ˈpɔt
caprice	ka.ˈpʁis
captivant	kap.ti.ˈvã
capturer	kap.ty.ˈʁe
capucine	ka.py.ˈsin
car	kaʁ
caractère	ka.ʁak.ˈtɛʁ
carbone	kaʁ.ˈbɔn
carotte	ka.ˈʁɔt
carpe	kaʁp
carreau	ka.ˈʁo
carte	kaʁt
carte postale	kaʁt.po.ˈstal
carthaginois	kaʁ.ta.ʒi.ˈnwa
carton	kaʁ.ˈtõ
cas	ka
cascade	ka.ˈskad
caserne	ka.ˈzɛʁn
casquette	ka.ˈskɛt
casserole	ka.sə.ˈʁɔl
cassette	ka.ˈsɛt
castillan	ka.sti.ˈjã
castor	ka.ˈstɔʁ
catalan	ka.ta.ˈlã
catastrophe	ka.ta.ˈstʁɔf
cathédrale	ka.te.ˈdʁal
catégorie	ka.te.gɔ.ˈʁi
cause	koz
causer	ko.ˈze
cautionner	ko.sjɔ.ˈne
cave	kav
ce	sə
ceci	sə.ˈsi
ceinture	sɛ̃.ˈtyʁ
cela	sə.ˈla
cellule	sɛ.ˈlyl
celte	sɛlt
celtique	sɛl.ˈtik
celui	sə.ˈlɥi
cendre	sãdʁ
cendrier	sãdʁ.ˈje
censurer	sã.sy.ˈʁe
cent	s
central	sã.ˈtʁal
centrale	sã.ˈtʁal
centre	sãtʁ
cependant	sə.pã.ˈdã
cercle	sɛʁkl
cercueil	sɛʁ.ˈkœj
cerf	sɛʁ
cerise	sə.ˈʁiz
cerisier	sə.ʁiz.ˈje
certain	sɛʁ.ˈtɛ̃
certainement	sɛʁ.tɛ.ˈnəm
certes	sɛʁt
certifier	sɛʁ.ti.ˈfje
cerveau	sɛʁ.ˈvo
cervelle	sɛʁ.ˈvɛl
cesser	sɛ.ˈse
ceylanais	sɛ.la.ˈnɛ
ce matin	sə.ma.ˈtɛ̃
ce soir	sə.ˈswaʁ
chacal	ʃa.ˈkal
chacun	ʃa.ˈky
chagrin	ʃa.ˈgʁɛ̃
chagriner	ʃa.gʁi.ˈne
chair	ʃɛʁ
chaise	ʃɛz
chambre	ʃãbʁ
chambre de travail	ʃãbʁ.də.tʁa.ˈvaj
chambre à coucher	ʃã.bʁa.ku.ˈʃe
chameau	ʃa.ˈmo
chamois	ʃa.ˈmwa
champ	ʃã
champagne	ʃã.ˈpanj
champignon	ʃã.pi.ˈnjõ
champion	ʃã.ˈpjõ
chance	ʃãs
chandail	ʃã.ˈdaj
chandelle	ʃã.ˈdɛl
changement d'adresse	ʃã.ʒəm.da.ˈdʁɛs
changer	ʃã.ˈʒe
chanson	ʃã.ˈsõ
chanter	ʃã.ˈte
chanteur	ʃã.ˈtœʁ
chanteuse	ʃã.ˈtøz
chaos	kao
chapeau	ʃa.ˈpo
chaperonner	ʃa.pə.ʁɔ.ˈne
chapitre	ʃa.ˈpitʁ
chaque	ʃak
chaque jour	ʃak.ˈʒuʁ
chaque semaine	ʃak.sə.ˈmɛn
char	ʃaʁ
charbon	ʃaʁ.ˈbõ
chardon	ʃaʁ.ˈdõ
chardonneret	ʃaʁ.dɔ.nə.ˈʁɛ
charger	ʃaʁ.ˈʒe
chariot	ʃa.ˈʁjo
charitable	ʃa.ʁi.ˈtabl
charlatan	ʃaʁ.la.ˈtã
charmant	ʃaʁ.ˈmã
charme	ʃaʁm
charnière	ʃaʁ.ˈnjɛʁ
charpenter	ʃaʁ.pã.ˈte
charrette	ʃa.ˈʁɛt
charrue	ʃa.ˈʁy
chasser	ʃa.ˈse
chasseur	ʃa.ˈsœʁ
chaste	ʃast
chat	ʃa
chatouiller	ʃa.tu.ˈje
chatte	ʃat
chaud	ʃo
chaudement	ʃo.ˈdəm
chaudron	ʃo.ˈdʁõ
chauffage	ʃo.ˈfaʒ
chauffer	ʃo.ˈfe
chauffeur	ʃo.ˈfœʁ
chaume	ʃom
chaumière	ʃo.ˈmjɛʁ
chaussette	ʃo.ˈsɛt
chaussure	ʃo.ˈsyʁ
chaussée	ʃo.ˈse
chauve	ʃov
chaux	ʃo
chaîne	ʃɛn
chaîne Côtière	ʃɛn.ko.ˈtjɛʁ
chef	ʃɛf
chemin	ʃə.ˈmɛ̃
cheminée	ʃə.mi.ˈne
chemin de fer	ʃə.mɛ̃.də.ˈfe
chemise	ʃə.ˈmiz
chenal Opimica	ʃə.na.lo.pi.mi.ˈka
chenal Raft	ʃə.nal.ˈʁaf
chenal de la Culbute	ʃə.nal.də.la.kyl.ˈbyt
chenille	ʃə.ˈnij
cher	ʃe
chercher	ʃɛʁ.ˈʃe
cheval	ʃə.ˈval
cheval entier	ʃə.va.lã.ˈtje
cheval hongre	ʃə.va.ˈlõgʁ
chevaucher	ʃə.vo.ˈʃe
cheveu	ʃə.ˈvø
cheveux	ʃə.ˈvø
cheville	ʃə.ˈvij
chevreuil	ʃə.ˈvʁœj
chez	ʃe
chicaner	ʃi.ka.ˈne
chien	ʃi
chiendent	ʃjɛ̃d
chiffon	ʃi.ˈfõ
chiffre	ʃifʁ
chilien	ʃi.ˈli
chimie	ʃi.ˈmi
chimiste	ʃi.ˈmist
chimère	ʃi.ˈmɛʁ
chirurgie	ʃi.ʁyʁ.ˈʒi
chirurgien	ʃi.ʁyʁ.ˈʒi
chlore	klɔʁ
chlorure de polyvinyle	klɔ.ʁyʁ.də.pɔ.li.vi.ˈnil
choc	ʃɔk
chocolat	ʃɔ.kɔ.ˈla
choisir	ʃwa.ˈziʁ
choix	ʃwa
choléra	ʃɔ.le.ˈʁa
choquer	ʃɔ.ˈke
chose	ʃoz
choses	ʃoz
chou	ʃu
chouette	ʃuɛt
choyer	ʃwa.ˈje
chrome	kʁom
chrétien	kʁe.ˈsi
chuchoter	ʃy.ʃɔ.ˈte
chute	ʃyt
chypriote	ʃi.ˈpʁjɔt
chèque	ʃɛk
chèvre	ʃɛvʁ
chèvrefeuille	ʃɛ.vʁə.ˈfœj
châle	ʃal
châtaigne	ʃa.ˈtɛnj
châtaignier	ʃa.tɛnj.ˈje
château	ʃa.ˈto
chêne	ʃɛn
ciboulette	si.bu.ˈlɛt
cicatrice	si.ka.ˈtʁis
cidre	sidʁ
ciel	sjɛl
cigare	si.ˈgaʁ
cigarette	si.ga.ˈʁɛt
cigogne	si.ˈgɔnj
cime	sim
ciment	sim
cimetière	si.mə.ˈtjɛʁ
cinq	sɛ̃k
cinquante	sɛ̃.ˈkãt
cinéma	si.ne.ˈma
circonstance	siʁ.kõ.ˈstãs
circulaire	siʁ.ky.ˈlɛʁ
circulation	siʁ.ky.la.ˈsjõ
circuler	siʁ.ky.ˈle
cire	siʁ
cire d'abeilles	siʁ.da.ˈbɛj
cirque	siʁk
ciseau	si.ˈzo
ciseaux	si.ˈzo
ciseler	si.zə.ˈle
citation	si.ta.ˈsjõ
citer	si.ˈte
citerne	si.ˈtɛʁn
citoyen	si.ˈtwaj
citron	si.ˈtʁõ
cité	si.ˈte
civil	si.ˈvil
clair	klɛʁ
clairon	klɛ.ˈʁõ
clamer	kla.ˈme
clameur	kla.ˈmœʁ
clapoter	kla.pɔ.ˈte
claquer	kla.ˈke
classe	klas
classique	kla.ˈsik
clavier	kla.ˈvje
clef	kle
client	kli
climat	kli.ˈma
climatisé	kli.ma.ti.ˈze
clique	klik
cloaque	kloak
cloche	klɔʃ
clochette	klo.ˈʃɛt
cloche de plongée	klɔʃ.də.plõ.ˈʒe
cloison	klwa.ˈzõ
clou	klu
clouer	klue
clown	klun
club	klœb
clébard	kle.ˈbaʁ
cobaye	kɔ.ˈbaj
cobra	kɔ.ˈbʁa
coccinelle	kok.si.ˈnɛl
coche	kɔʃ
cochon	ko.ˈʃõ
cochonnet	ko.ʃɔ.ˈnɛ
cochon d'Inde	ko.ʃõ.ˈdɛ̃d
coffre	kɔfʁ
coffret	kɔ.ˈfʁɛ
cognac	kɔ.ˈnjak
cohérent	koeʁ
coiffer	kwa.ˈfe
coiffeur	kwa.ˈfœʁ
coiffeuse	kwa.ˈføz
coin	kwɛ̃
coing	kwɛ̃
col	kɔl
colimaçon	kɔ.li.ma.ˈsõ
colis	kɔ.ˈli
colle	kɔl
collection	kɔ.lɛk.ˈsjõ
collectionner	kɔ.lɛk.sjɔ.ˈne
collection à consulter	kɔ.lɛk.sjõa.kõ.syl.ˈte
coller	kɔ.ˈle
colline	kɔ.ˈlin
colline Boundary	kɔ.lin.bu.da.ˈʁi
collision	kɔ.liz.ˈjõ
collège	kɔ.ˈlɛʒ
collègue	kɔ.ˈlɛg
colombe	kɔ.ˈlõb
colombien	kɔ.lõ.ˈbi
colonel	kɔ.lo.ˈnɛl
colonial	kɔ.lo.ˈnjal
colonie	kɔ.lo.ˈni
colonne	kɔ.ˈlɔn
colonne de journal	kɔ.lɔn.də.ʒuʁ.ˈnal
colonne vertébrale	kɔ.lɔn.vɛʁ.te.ˈbʁal
combat	kõ.ˈba
combattre	kõ.ˈbatʁ
combien	kõ.ˈbi
combien de	kõ.bi.ˈdə
comble	kõbl
combler	kõ.ˈble
comique	ko.ˈmik
comité	ko.mi.ˈte
commandant	kɔ.mã.ˈdã
commande	kɔ.ˈmãd
commandement	kɔ.mã.ˈdəm
commander	kɔ.mã.ˈde
commando	kɔ.mã.ˈdo
comme	kɔm
commencement	kɔ.mã.ˈsəm
commencer	kɔ.mã.ˈse
comment	kɔm
commerce	kɔ.ˈmɛʁs
commerçant	kɔ.mɛʁ.ˈsã
commetre yne faute	kɔ.mətʁjn.ˈfot
comme cela	kɔm.sə.ˈla
comme ci, comme ça	kɔm.si.kɔm.ˈsa
commissariat	kɔ.mi.sa.ˈʁja
commission	kɔ.mi.ˈsjõ
commode	kɔ.ˈmɔd
commun	kɔ.ˈmœ̃
commune	kɔ.ˈmyn
communication	kɔ.my.ni.ka.ˈsjõ
communion	kɔ.my.ˈnjõ
communiquer	kɔ.my.ni.ˈke
commuter	kɔ.my.ˈte
compagnie	kõ.pa.ˈnji
compagnon	kõ.pa.ˈnjõ
comparaison	kõ.pa.ʁɛ.ˈzõ
comparer	kõ.pa.ˈʁe
compartiment	kõ.paʁ.ˈtim
compassion	kõ.pa.ˈsjõ
compatir	kõ.pa.ˈtiʁ
compenser	kõ.pã.ˈse
complaisance	kõ.plɛ.ˈzãs
complaisant	kõ.plɛ.ˈzã
complet	kõ.ˈplɛ
compliment	kõ.ˈplim
compliquer	kõ.pli.ˈke
comploter	kõ.plɔ.ˈte
compléter	kõ.plɛ.ˈte
complètement	kõ.plɛ.ˈtəm
composer	kõ.po.ˈze
composition	kõ.po.zi.ˈsjõ
comprendre	kõ.ˈpʁãdʁ
compromis	kõ.pʁo.ˈmi
compte	kõt
compter	kõ.ˈte
compétent	kõ.ˈpɛt
comte	kõt
comète	ko.ˈmɛt
con	kõ
concernant	kõ.sɛʁ.ˈnã
concerner	kõ.sɛʁ.ˈne
concerné	kõ.sɛʁ.ˈne
concert	kõ.ˈsɛʁ
concevoir	kõ.sə.ˈvwaʁ
conciliant	kõ.si.ˈljã
concis	kõ.ˈsi
conclure	kõ.ˈklyʁ
concombre	kõ.ˈkõbʁ
concordance	kõ.kɔʁ.ˈdãs
concorder	kõ.kɔʁ.ˈde
concourir	kõ.ku.ˈʁiʁ
concours	kõ.ˈkuʁ
concret	kõ.ˈkʁɛ
condamner	kõ.da.ˈne
condition	kõ.di.ˈsjõ
condom	kõ.ˈdõm
conduire	kõ.ˈdɥiʁ
confectionner	kõ.fɛk.sjɔ.ˈne
confession	kõ.fɛ.ˈsjõ
confiance	kõ.ˈfjãs
confier	kõ.ˈfje
confier une tâche	kõ.fjeyn.ˈtaʃ
confire	kõ.ˈfiʁ
confirmer	kõ.fiʁ.ˈme
confisquer	kõ.fi.ˈske
confiture	kõ.fi.ˈtyʁ
conflit	kõ.ˈfli
confondre	kõ.ˈfõdʁ
conforme	kõ.ˈfɔʁm
conforme à	kõ.fɔʁ.ˈma
conformément	kõ.fɔʁ.ˈmem
confort	kõ.ˈfɔʁ
confortable	kõ.fɔʁ.ˈtabl
confu	kõ.ˈfy
confus	kõ.ˈfy
conférence	kõ.fe.ˈʁãs
congestion	kõ.ʒɛst.ˈjõ
congrès	kõ.ˈgʁɛ
congé	kõ.ˈʒe
conjecturer	kõ.ʒɛk.ty.ˈʁe
connaissance	ko.nɛ.ˈsãs
connaître	kɔ.ˈnɛtʁ
connecter	kɔ.nɛk.ˈte
connu	ko.ˈny
conque	kõk
conquérir	kõ.ke.ˈʁiʁ
consacrer	kõ.sa.ˈkʁe
conscience	kõ.ˈsjãs
conscient	kõ.ˈsi
conseil	kõ.ˈsɛj
conseiller	kõ.sɛ.ˈje
conseilleur	kõ.sɛ.ˈjœʁ
consentir	kõ.sã.ˈtiʁ
conserver	kõ.sɛʁ.ˈve
considérable	kõ.si.de.ˈʁabl
considérer	kõ.si.de.ˈʁe
consister	kõ.si.ˈste
consolation	kõ.sɔ.la.ˈsjõ
consoler	kõ.sɔ.ˈle
consommateur	kõ.so.ma.ˈtœʁ
consommation	kõ.sɔ.ma.ˈsjõ
consommer	kõ.sɔ.ˈme
constamment	kõ.ˈstam
constant	kõ.ˈstã
constater	kõ.sta.ˈte
consterner	kõ.stɛʁ.ˈne
construction	kõ.stʁyk.ˈsjõ
construire	kõstʁ.ˈɥiʁ
consulat	kõ.sy.ˈla
consulter	kõ.syl.ˈte
consumer	kõ.sy.ˈme
conséquence	kõ.se.ˈkãs
contact	kõ.ˈtakt
conte	kõt
contempler	kõ.tã.ˈple
contenir	kõ.tə.ˈniʁ
content	kõt
contenter	kõ.tã.ˈte
contenu	kõ.tə.ˈny
conter	kõ.ˈte
conter fleurette	kõ.te.flœ.ˈʁɛt
contester	kõ.tɛ.ˈste
continent	kõ.ˈtin
contingent	kõ.ˈtɛ̃ʒ
continuel	kõ.ti.ˈnyɛl
continuellement	kõ.ti.nyɛ.ˈləm
continuer	kõ.ti.ˈnye
continuer à	kõ.ti.ˈnyea
contracter	kõ.tʁak.ˈte
contradictoire	kõ.tʁa.dik.ˈtwaʁ
contraindre	kõ.ˈtʁɛ̃dʁ
contre	kõtʁ
contribuer	kõ.tʁi.ˈbye
contrée	kõ.ˈtʁe
contrôleur	kõ.tʁo.ˈlœʁ
convaincre	kõ.ˈvɛ̃kʁ
convenable	kõ.və.ˈnabl
convenablement	kõ.və.na.ˈbləm
convenir	kõ.və.ˈniʁ
convention	kõ.vã.ˈtjõ
conversation	kõ.vɛʁ.sa.ˈsjõ
convertir	kõ.vɛʁ.ˈtiʁ
conviction	kõ.vik.ˈsjõ
convive	kõ.ˈviv
copier	ko.ˈpje
coq	kɔk
coque	kɔk
coquelicot	kɔ.kə.li.ˈko
coquet	kɔ.ˈkɛ
coquille	kɔ.ˈkij
corbeau	kɔʁ.ˈbo
corbeille	kɔʁ.ˈbɛj
corde	kɔʁd
cordonnier	kɔʁ.dɔ.ˈnje
corinthien	ko.ʁɛ̃.ˈti
cormoran	kɔʁ.mɔ.ˈʁã
corne	kɔʁn
corps	kɔʁ
correspondance	ko.ʁɛ.spõ.ˈdãs
correspondant	ko.ʁɛ.spõ.ˈdã
correspondre	ko.ʁɛ.ˈspõdʁ
correspondre à	ko.ʁɛ.spõ.ˈdʁa
corridor	ko.ʁi.ˈdɔʁ
corriger	ko.ʁi.ˈʒe
corrompre	kɔ.ˈʁõpʁ
corse	kɔʁs
cortège	kɔʁ.ˈtɛʒ
coréen	kɔ.ˈʁe
cosmos	ko.ˈsmos
costaricien	ko.sta.ʁi.ˈsi
costume	ko.ˈstym
cotisation	kɔ.ti.za.ˈsjõ
coton	ko.ˈtõ
cou	ku
couche	kuʃ
coucher	ku.ˈʃe
coucou	ku.ˈku
coude	kud
coudre	kudʁ
couler	ku.ˈle
couleur	ku.ˈlœʁ
couleuvre	ku.ˈlœvʁ
couloir	ku.ˈlwaʁ
coup	ku
coupable	ku.ˈpabl
coupant	ku.ˈpã
coupe	kup
couper	ku.ˈpe
couper avec des ciseaux	ku.pea.vɛk.de.si.ˈzo
couple	kupl
coupler	ku.ˈple
coupon	ku.ˈpõ
cour	kuʁ
courage	ku.ˈʁaʒ
courageux	ku.ʁa.ˈʒø
courant	ku.ˈʁã
courbe	kuʁb
courber	kuʁ.ˈbe
courgette	kuʁ.ˈʒɛt
courir	ku.ˈʁiʁ
couronner	ku.ʁɔ.ˈne
courrier	ku.ˈʁje
courroie	ku.ˈʁwa
cours	kuʁ
court	kuʁ
courtois	kuʁ.ˈtwa
cousin	ku.ˈzɛ̃
cousine	ku.ˈzin
coussin	ku.ˈsɛ̃
coussin d'air	ku.sɛ̃.ˈdɛʁ
couteau	ku.ˈto
coutume	ku.ˈtym
couture	ku.ˈtyʁ
couturière	ku.ty.ˈʁjɛʁ
couvent	kuv
couver	ku.ˈve
couvert	ku.ˈvɛʁ
couverture	ku.vɛʁ.ˈtyʁ
couvrir	ku.ˈvʁiʁ
coyote	kɔ.ˈjɔt
coïncider	koɛ̃.si.ˈde
coïter	koi.ˈte
coûter	ku.ˈte
coûteux	ku.ˈtø
crabe	kʁab
cracher	kʁa.ˈʃe
craie	kʁɛ
craindre	kʁɛ̃dʁ
crainte	kʁɛ̃t
crapaud	kʁa.ˈpo
craquement	kʁa.ˈkəm
craquer	kʁa.ˈke
cravate	kʁa.ˈvat
crayon	kʁɛ.ˈjõ
creuser	kʁø.ˈze
creux	kʁø
crever	kʁə.ˈve
crevette	kʁə.ˈvɛt
cri	kʁi
criard	kʁjaʁ
crier	kʁie
crime	kʁim
criquet	kʁi.ˈkɛ
crise	kʁiz
cristal	kʁi.ˈstal
critique	kʁi.ˈtik
critiquer	kʁi.ti.ˈke
croasser	kʁoa.ˈse
croate	kʁot
crochet	kʁo.ˈʃɛ
crocodile	kʁo.ko.ˈdil
croire	kʁwaʁ
croiser	kʁwa.ˈze
croix	kʁwa
croupe	kʁup
croître	kʁwatʁ
cru	kʁy
cruche	kʁyʃ
crucifix	kʁy.si.ˈfi
cruel	kʁyɛl
créature	kʁea.ˈtyʁ
créer	kʁee
crème	kʁɛm
crème glacée	kʁɛm.gla.ˈse
crâne	kʁan
crêpe	kʁɛp
crête	kʁɛt
cubain	ky.ˈbɛ̃
cube	kyb
cueillir	kœ.ˈjiʁ
cuiller	kœ.ˈje
cuillère	kɥi.ˈjɛʁ
cuir	kɥiʁ
cuire	kɥiʁ
cuir à rasoir	kɥi.ʁa.ʁaz.ˈwaʁ
cuisine	kɥi.ˈzin
cuisiner	kɥi.zi.ˈne
cuisinier	kɥi.zi.ˈnje
cuisinière	kɥi.zi.ˈnjɛʁ
cuisse	kɥis
cuivre	kɥivʁ
cul	ky
culotte	ky.ˈlɔt
culte	kylt
cultiver	kyl.ti.ˈve
cultivé	kyl.ti.ˈve
culture	kyl.ˈtyʁ
curieux	ky.ˈʁjø
curiosité	ky.ʁjo.zi.ˈte
curé	ky.ˈʁe
cuve	kyv
cycle	sikl
cyclone	si.ˈklon
cygne	sinj
cylindre	si.ˈlɛ̃dʁ
cynique	si.ˈnik
cyprès	si.ˈpʁɛ
c'	s
c'est pourquoi	sɛst.puʁ.ˈkwa
céder	se.ˈde
céleri	se.lə.ˈʁi
célibataire	se.li.ba.ˈtɛʁ
célébrer	se.le.ˈbʁe
célèbre	se.ˈlɛbʁ
cérémonie	se.ʁe.mɔ.ˈni
césium	sez.ˈjɔm
cèdre	sɛdʁ
câble	kabl
côte	kot
côtelette	ko.tə.ˈlɛt
côte rivage	ko.tʁi.ˈvaʒ
côté	ko.ˈte
dactyle	dak.ˈtil
dactylographe	dak.ti.lo.ˈgʁaf
dactylographier	dak.ti.lo.gʁa.ˈfje
dahlia	da.ˈlja
daltonnien	dal.tɔ.ˈni
dame	dam
danger	dã.ˈʒe
dangereux	dã.ʒə.ˈʁø
dans	dã
danse	dãs
danser	dã.ˈse
dans le vent	dã.ˈləv
dans l'intervalle	dã.li.tɛʁ.ˈval
date	dat
dater	da.ˈte
datte	dat
dauphin	do.ˈfɛ̃
davantage	da.vã.ˈtaʒ
de	də
debout	də.ˈbu
dedans	də.ˈdã
degré	də.ˈgʁe
dehors	dəɔʁ
delta	dɛl.ˈta
demain	də.ˈmɛ̃
demain matin	də.mɛ̃.ma.ˈtɛ̃
demain soir	də.mɛ̃.ˈswaʁ
demander	də.mã.ˈde
demander l'aumône	də.mã.de.lo.ˈmon
demeure	də.ˈmœʁ
demeurer	də.mœ.ˈʁe
demi	də.ˈmi
demoiselle	də.mwa.ˈzɛl
demoiselle noble	də.mwa.zɛl.ˈnɔbl
denrée	dã.ˈʁe
dense	dãs
dent	d
dentelle	dã.ˈtɛl
dentiste	dã.ˈtist
depuis	də.ˈpɥi
dernier	dɛʁ.ˈnje
dernier cri	dɛʁ.nje.ˈkʁi
dernièrement	dɛʁ.njɛ.ˈʁəm
derrière	dɛ.ˈʁjɛʁ
des	de
descendance	dɛ.sã.ˈdãs
descendant	dɛ.sã.ˈdã
descendre	dɛ.ˈsãdʁ
descendre en rappel	dɛ.sãdʁ.ʁa.ˈpɛl
descente	dɛ.ˈsãt
description	dɛ.skʁips.ˈjõ
dessein	dɛ.ˈsɛ̃
dessert	dɛ.ˈsɛʁ
dessin	dɛ.ˈsɛ̃
dessiner	dɛ.si.ˈne
dessous	dɛ.ˈsu
dessus	də.ˈsy
destinataire	dɛ.sti.na.ˈtɛʁ
destination	dɛ.sti.na.ˈsjõ
destiner	dɛ.sti.ˈne
destinée	dɛ.sti.ˈne
des Philippines	de.fi.li.ˈpin
dette	dɛt
deuil	dœj
deux	dø
deuxième	døz.ˈjɛm
deuxième Sault	døz.jɛm.ˈsolt
deux cents	døs
devant	də.ˈvã
devenir	də.və.ˈniʁ
deviner	də.vi.ˈne
devise	də.ˈviz
devoir	də.ˈvwaʁ
de bonne heure	də.bɔ.ˈnœʁ
de cette manière	də.sɛt.ma.ˈnjɛʁ
de façon ou d'autre	də.fa.sõu.ˈdotʁ
de la	də.ˈla
de l'Allemagne occidentale	də.la.lə.ma.njok.si.dã.ˈtal
de l'Amérique du Nord	də.la.me.ʁik.dy.ˈnɔʁ
de moins en moins	də.mwɛ̃.ˈmwɛ̃
de même	də.ˈmɛm
de nouveau	də.nu.ˈvo
de plus en plus	də.ply.ˈply
de proche en proche	də.pʁɔʃ.ˈpʁɔʃ
de préférence	də.pʁe.fe.ˈʁãs
de quelle manière	də.kɛl.ma.ˈnjɛʁ
de quelqu'un	də.kɛl.ˈky
de suite	də.ˈsɥit
de temps en temps	də.tã.ˈtã
de toute manière	də.tut.ma.ˈnjɛʁ
diable	djabl
dialecte	dja.ˈlɛkt
dialogue	dja.ˈlɔg
diamant	dja.ˈmã
diarrhée	dja.ˈʁe
dictateur	dik.ta.ˈtœʁ
dicter	dik.ˈte
dictionnaire	dik.sjɔ.ˈnɛʁ
dieu	djø
diffamer	di.fa.ˈme
difficile	di.fi.ˈsil
difficilement	di.fi.si.ˈləm
différence	di.fe.ˈʁãs
différent	di.ˈfeʁ
différer	di.fe.ˈʁe
digitale	di.ʒi.ˈtal
digne	dinj
dignité	di.nji.ˈte
digérer	di.ʒe.ˈʁe
diluer	di.ˈlye
dimanche	di.ˈmãʃ
dimension	di.mã.ˈsjõ
diminuer	di.mi.ˈnye
dindon	dɛ̃.ˈdõ
diplôme	di.ˈplom
diplôme de fin d'études	di.plom.də.fɛ̃.de.ˈtyd
dire	diʁ
direct	di.ˈʁɛkt
directement	di.ʁɛk.ˈtəm
directeur	di.ʁɛk.ˈtœʁ
direction	di.ʁɛk.ˈsjõ
dire adieu	di.ʁa.ˈdjø
dirigeable	di.ʁi.ˈʒabl
diriger	di.ʁi.ˈʒe
discerner	di.sɛʁ.ˈne
disciple	di.ˈsipl
discipline	di.si.ˈplin
discours	di.ˈskuʁ
discret	di.ˈskʁɛ
discussion	di.sky.ˈsjõ
discuter	di.sky.ˈte
disparaître	di.spa.ˈʁɛtʁ
disparition	di.spa.ʁi.ˈsjõ
dispenser	di.spã.ˈse
disperser	di.spɛʁ.ˈse
disposer	di.spo.ˈze
disposer de	di.spo.ze.ˈdə
disposition	di.spo.zi.ˈsjõ
dispute	di.ˈspyt
disputer	di.spy.ˈte
disque	disk
disquette	di.ˈskɛt
dissiper	di.si.ˈpe
distance	di.ˈstãs
distinction	di.stik.ˈsjõ
distinguer	di.stɛ̃.ˈge
distraction	di.stʁak.ˈsjõ
distraire	di.ˈstʁɛʁ
distrait	di.ˈstʁɛ
distribuer	di.stʁi.ˈbye
distribution	di.stʁi.by.ˈtjõ
district de Franklin	di.stʁikt.də.fʁã.ˈklɛ̃
district de Keewatin	di.stʁikt.də.ki.wa.ˈtɛ̃
district de Mackenzie	di.stʁikt.də.ma.kã.ˈzi
divers	di.ˈvɛʁ
divin	di.ˈvɛ̃
diviser	di.vi.ˈze
divorce	di.ˈvɔʁs
dix	dis
diète	djɛt
docile	do.ˈsil
docilité	do.si.li.ˈte
docteur	dɔk.ˈtœʁ
docteur médecin	dɔk.tœʁ.me.də.ˈsɛ̃
document	do.ˈkym
dogme	dɔgm
doigt	dwa
doigt du pied	dwa.dy.ˈpje
dollar	dɔ.ˈlaʁ
domaine	do.ˈmɛn
domestique	do.mɛ.ˈstik
domicile	do.mi.ˈsil
dominant	do.mi.ˈnã
dominateur	do.mi.na.ˈtœʁ
dominer	do.mi.ˈne
dominicain	do.mi.ni.ˈkɛ̃
dommage	dɔ.ˈmaʒ
don	dõ
donner	dɔ.ˈne
donner l'assaut	dɔ.ne.la.ˈso
donner son accord	dɔ.ne.sõa.ˈkɔʁ
dont	dõ
don Quichotte	dõ.ki.ˈʃɔt
dorer	dɔ.ˈʁe
dorien	dɔ.ˈʁi
dorique	do.ˈʁik
dorloter	doʁ.lɔ.ˈte
dormir	dɔʁ.ˈmiʁ
dortoir	dɔʁ.ˈtwaʁ
dos	do
dossier	do.ˈsje
douane	dwan
double	dubl
doubler	du.ˈble
doucereux	du.sə.ˈʁø
douche	duʃ
douleur	du.ˈlœʁ
doute	dut
douter	du.ˈte
doux	du
douzaine	du.ˈzɛn
douze	duz
douzième	duz.ˈjɛm
drainer	dʁɛ.ˈne
drap	dʁa
drapeau	dʁa.ˈpo
drap de lit	dʁa.də.ˈli
dresser	dʁɛ.ˈse
drogue	dʁɔg
droit	dʁwa
droit de régie	dʁwa.də.ʁe.ˈʒi
drôle	dʁol
du	dy
duché	dy.ˈʃe
dur	dyʁ
durant	dy.ˈʁã
durcir	dyʁ.ˈsiʁ
durer	dy.ˈʁe
durée	dy.ˈʁe
duvet	dy.ˈvɛ
dynamite	di.na.ˈmit
dyspepsie	di.spɛ.ˈpsi
d'Afrikanders	da.fʁi.kã.ˈdɛʁ
d'Islande	dɛ̃s.ˈlãd
d'abord	da.ˈbɔʁ
d'acier	da.ˈsje
d'adieu	da.ˈdjø
d'ailleurs	da.ˈjœʁ
d'après	da.ˈpʁɛ
d'eau	do
d'où	du
d'une façon ou d'une autre	dyn.fa.sõu.dy.ˈnotʁ
débarcadère	de.baʁ.ka.ˈdɛʁ
débarquer	de.baʁ.ˈke
débarrasser	de.ba.ʁa.ˈse
débat	de.ˈba
débattre	de.ˈbatʁ
débit	de.ˈbi
débiter	de.bi.ˈte
déborder	de.bɔʁ.ˈde
débris	de.ˈbʁi
début	de.ˈby
débuter	de.by.ˈte
décembre	de.ˈsãbʁ
déception	de.sɛps.ˈjõ
décharger	de.ʃaʁ.ˈʒe
déchirer	de.ʃi.ˈʁe
décider	de.si.ˈde
décision	de.siz.ˈjõ
déclaration	de.kla.ʁa.ˈsjõ
déclarer	de.kla.ˈʁe
décor	de.ˈkɔʁ
décoration	de.kɔ.ʁa.ˈsjõ
décorer	de.kɔ.ˈʁe
découper	de.ku.ˈpe
découverte	de.ku.ˈvɛʁt
découvrir	de.ku.ˈvʁiʁ
décrire	de.ˈkʁiʁ
décéder	de.se.ˈde
dédaigner	de.dɛ.ˈnje
dédier	de.ˈdje
déduire	de.ˈdɥiʁ
défaut	de.ˈfo
défendre	de.ˈfãdʁ
défense	de.ˈfãs
défiler	de.fi.ˈle
défilé Woolsey	de.fi.le.wul.ˈsɛ
définer	de.fi.ˈne
définitif	de.fi.ni.ˈtif
déféquer	de.fe.ˈke
dégager	de.ga.ˈʒe
dégeler	deʒ.ˈle
dégoût	de.ˈgu
dégoûtant	de.gu.ˈtã
dégât	de.ˈga
déjeuner	de.ʒœ.ˈne
déjà	de.ˈʒa
délabré	de.la.ˈbʁe
délaisser	de.lɛ.ˈse
délicat	de.li.ˈka
délice	de.ˈlis
délicieux	de.li.ˈsjø
délirer	de.li.ˈʁe
délivrer	de.li.ˈvʁe
déléguer	de.le.ˈge
délétère	de.le.ˈtɛʁ
démanger	de.mã.ˈʒe
démarche	de.ˈmaʁʃ
démarrer	de.ma.ˈʁe
démissioner	de.mi.sjo.ˈne
démocrate	de.mɔ.ˈkʁat
démolir	de.mɔ.ˈliʁ
démontrer	de.mõ.ˈtʁe
déménagement	de.me.na.ˈʒəm
dénoncer	de.nõ.ˈse
dénonciation	de.nõ.sja.ˈsjõ
dénudé	de.ny.ˈde
départ	de.ˈpaʁ
dépasser	de.pa.ˈse
dépeindre	de.ˈpɛ̃dʁ
dépendre	de.ˈpãdʁ
dépense	de.ˈpãs
dépenser	de.pã.ˈse
déployer	de.plwa.ˈje
déposer	de.po.ˈze
dépouiller	de.pu.ˈje
député	de.py.ˈte
déranger	de.ʁã.ˈʒe
dériver	de.ʁi.ˈve
dérober	de.ʁɔ.ˈbe
désagréable	de.za.ˈgʁeabl
désastre	de.ˈzastʁ
désert	de.ˈzɛʁ
désespoir	de.zɛsp.ˈwaʁ
désespérer	de.zɛ.spe.ˈʁe
déshabiller	de.za.bi.ˈje
désigner	de.zi.ˈnje
désir	de.ˈziʁ
désirer	de.zi.ˈʁe
désobéissant	de.zɔ.bei.ˈsã
désolation	de.zɔ.la.ˈsjõ
désoler	de.zɔ.ˈle
désolé	de.zɔ.ˈle
désordre	de.ˈzɔʁdʁ
déstination	de.sti.na.ˈsjõ
détachement	de.ta.ˈʃəm
détacher	de.ta.ˈʃe
détail	de.ˈtaj
détente	de.ˈtãt
déterminer	de.tɛʁ.mi.ˈne
détester	de.tɛ.ˈste
détourner	de.tuʁ.ˈne
détroit	de.ˈtʁwa
détroit Davis	de.tʁwa.da.ˈvi
détroit de Belle Ile	de.tʁwa.də.bɛ.ˈlil
détroit de Cabot	de.tʁwa.də.ka.ˈbo
détroit de Northumberland	de.tʁwa.də.noʁ.ty.bɛʁ.ˈlã
détruire	de.ˈtʁɥiʁ
détériorer	de.te.ʁjɔ.ˈʁe
développement	de.və.lɔ.ˈpəm
développer	de.və.lɔ.ˈpe
dévier	de.ˈvje
dévorer	de.vɔ.ˈʁe
dévouement	de.ˈvum
dévoué	de.ˈvue
dévoyer	de.vwa.ˈje
déçu	de.ˈsy
dé à coudre	dea.ˈkudʁ
dès	dɛ
dîner	di.ˈne
eau	o
edelweiss	ə.də.lwɛ.ˈjis
effacer	ɛ.fa.ˈse
effacer en grattant	ɛ.fa.se.gʁa.ˈtã
effectif	ɛ.fɛk.ˈtif
effet	ɛ.ˈfɛ
effleurer	ɛ.flœ.ˈʁe
effort	ɛ.ˈfɔʁ
effraie	ɛ.ˈfʁɛ
effroi	ɛ.ˈfʁwa
eh bien	ɛ.ˈbi
elle	ɛl
elles	ɛl
embarras	ã.ba.ˈʁa
embaucher	ã.bo.ˈʃe
embaumer	ã.bo.ˈme
embellir	ã.bɛ.ˈliʁ
embouchure	ã.bu.ˈʃyʁ
embrasser	ã.bʁa.ˈse
emmailloter	ã.ma.jɔ.ˈte
empereur	ã.pə.ˈʁœʁ
emphase	ã.ˈfaz
empire	ã.ˈpiʁ
emplette	ã.ˈplɛt
emploi	ã.ˈplwa
employer	ã.plwa.ˈje
employé	ã.plwa.ˈje
empreinte	ã.ˈpʁɛ̃t
empressement	ã.pʁɛ.ˈsəm
emprunter	ã.pʁy.ˈte
emprunter sur gages	ã.pʁy.te.syʁ.ˈgaʒ
empêcher	ã.pɛ.ˈʃe
empêtrer	ã.pɛ.ˈtʁe
enchantement	ã.ʃã.ˈtəm
enchanter	ã.ʃã.ˈte
enchaînement	ã.ʃɛ.ˈnəm
enchaîner	ã.ʃɛ.ˈne
enclin	ã.ˈklɛ̃
enclin aux accidents	ã.klɛ̃oak.ˈsid
encoche	ã.ˈkɔʃ
encore	ã.ˈkɔʁ
encre	ãkʁ
encyclopédie	ã.si.klɔ.pe.ˈdi
endommager	ã.do.ma.ˈʒe
endroit	ã.ˈdʁwa
enduire	ã.ˈdɥiʁ
endurer	ã.dy.ˈʁe
enfant	ã.ˈfã
enfants	ã.ˈfã
enfant adoptif	ã.fãa.dɔp.ˈtif
enfin	ã.ˈfɛ̃
enflammer	ã.fla.ˈme
engendrer	ã.ʒã.ˈdʁe
engrais	ã.ˈgʁɛ
enjoindre	ã.ˈʒwɛ̃dʁ
enlever	ã.lə.ˈve
ennemi	ɛ.nə.ˈmi
ennuyer	ã.nɥi.ˈje
ennuyeux	ã.nɥi.ˈjø
enquête	ã.ˈkɛt
enregistrer	ã.ʁə.ʒi.ˈstʁe
enrouler	ã.ʁu.ˈle
enrôler	ã.ʁo.ˈle
enseigne	ã.ˈsɛnj
enseignement	ã.sɛ.ˈnjəm
enseigner	ã.sɛ.ˈnje
ensemble	ã.ˈsãbl
ensoleillé	ã.sɔ.lɛ.ˈje
ensorceler	ã.sɔʁ.sə.ˈle
ensuite	ã.ˈsɥit
entamer	ã.ta.ˈme
entasser	ã.ta.ˈse
entendre	ã.ˈtãdʁ
entente	ã.ˈtãt
enterrement	ã.tɛ.ˈʁəm
enthousiasme	ã.tuz.ˈjasm
entier	ã.ˈtje
entièrement	ã.tjɛ.ˈʁəm
entonner	ã.tɔ.ˈne
entonnoir	ã.tɔ.ˈnwaʁ
entortiller	ã.tɔʁ.ti.ˈje
entourer	ã.tu.ˈʁe
entraîner	ã.tʁɛ.ˈne
entraîner des conséquences	ã.tʁɛ.ne.de.kõ.se.ˈkãs
entraîner hors du droit chemin	ã.tʁɛ.neɔʁ.dy.dʁwa.ʃə.ˈmɛ̃
entre	ãtʁ
entreprendre	ã.tʁə.ˈpʁãdʁ
entrer	ã.ˈtʁe
entrer dans	ã.tʁe.ˈdã
entrevue	ã.tʁə.ˈvy
entrée	ã.ˈtʁe
envahir	ã.ˈvaiʁ
enveloppe	ã.və.ˈlɔp
envie	ã.ˈvi
envier	ã.ˈvje
environ	ã.vi.ˈʁõ
environnement	ã.vi.ʁo.ˈnəm
envoyer	ã.vwa.ˈje
envoyeur	ã.vwa.ˈjœʁ
en accord avec	a.kɔ.ʁa.ˈvɛk
en aucune façon	o.kyn.fa.ˈsõ
en aucune manière	o.kyn.ma.ˈnjɛʁ
en avant	a.ˈvã
en dehors de	dəɔʁ.ˈdə
en dépit de	de.pi.ˈdə
en face de	fas.ˈdə
en fait	fɛ
en gros	gʁo
en général	ʒe.ne.ˈʁal
en haut	o
en imposer à	ɛ̃.po.ˈzea
en largeur	laʁ.ˈʒœʁ
en même temps	mɛm.ˈtã
en outre	utʁ
en partie	paʁ.ˈti
en passant	pa.ˈsã
en premier lieu	pʁə.mje.ˈljø
en prime	pʁim
en présence de	pʁe.zãs.ˈdə
en relation avec	ʁə.la.sjõa.ˈvɛk
en réalité	ʁea.li.ˈte
en sûreté	sy.ʁə.ˈte
en tous temps	tu.ˈtã
en vain	vɛ̃
en vérité	ve.ʁi.ˈte
errer	ɛ.ˈʁe
erreur	ɛ.ˈʁœʁ
escadron aérien	ɛ.ska.dʁõae.ˈʁi
escalier	ɛ.ska.ˈlje
escargot	ɛ.skaʁ.ˈgo
escarpé	ɛ.skaʁ.ˈpe
esclave	ɛ.ˈsklav
escorte	ɛ.ˈskɔʁt
espace	ɛ.ˈspas
espagnol	ɛ.spa.ˈnjɔl
espion	ɛsp.ˈjõ
esplanade	ɛ.spla.ˈnad
espoir	ɛsp.ˈwaʁ
esprit	ɛ.ˈspʁi
espérance	ɛ.spe.ˈʁãs
espéranto	ɛ.spe.ʁã.ˈto
espérer	ɛ.spe.ˈʁe
espèce	ɛ.ˈspɛs
espèce biologique	ɛ.spɛs.bjo.lo.ˈʒik
esquisse	ɛ.ˈskis
esquisser	ɛ.ski.ˈse
essai	ɛ.ˈsɛ
essayer	e.se.ˈje
essence	ɛ.ˈsãs
essentiel	ɛ.sã.ˈsjɛl
essuyer	ɛ.syi.ˈje
est	ɛst
estampiller	ɛ.stã.pi.ˈje
estime	ɛ.ˈstim
estimer	ɛ.sti.ˈme
estomac	ɛ.stɔ.ˈma
estonien	ɛ.sto.ˈni
estrade	ɛ.ˈstʁad
esturgeon	ɛ.styʁ.ˈʒõ
et	e
etc.	ɛtk
et puis	e.ˈpɥi
exact	ɛg.ˈza
exactement	ɛg.zak.ˈtəm
exactitude	ɛg.zak.ti.ˈtyd
examen	ɛg.za.ˈmɛn
examen de sortie	ɛg.za.mɛn.də.sɔʁ.ˈti
examen final	ɛg.za.mɛn.fi.ˈnal
examiner	ɛg.za.mi.ˈne
excellent	ɛk.ˈsɛl
excepter	ɛk.sɛp.ˈte
exciter	ɛk.si.ˈte
excrément	ɛk.ˈskʁem
excursion	ɛk.skyʁ.ˈsjõ
excuser	ɛk.sky.ˈze
excès	ɛk.ˈsɛ
exemple	ɛg.ˈzãpl
exempter	ɛg.zãp.ˈte
exercer	ɛg.zɛʁ.ˈse
exercice	ɛg.zɛʁ.ˈsis
exhalaison	ɛg.za.lɛ.ˈzõ
exhaler un odeur	ɛg.za.leœ̃o.ˈdœʁ
exhorter	ɛg.zɔʁ.ˈte
exiger	ɛg.zi.ˈʒe
exiler	ɛg.zi.ˈle
exister	ɛg.zi.ˈste
experimenté	ɛk.spə.ʁi.mã.ˈte
expliquer	ɛk.spli.ˈke
exploitant	ɛkspl.wa.ˈtã
exploiter	ɛkspl.wa.ˈte
explorer	ɛk.splɔ.ˈʁe
exploser	ɛk.splo.ˈze
exposition agricole	ɛk.spo.zi.sjõa.gʁi.ˈkɔl
exposé	ɛk.spo.ˈze
exprimer	ɛk.spʁi.ˈme
exprès	ɛk.ˈspʁɛ
expédier	ɛk.spe.ˈdje
expérience	ɛk.spe.ˈʁjãs
exterminer	ɛk.stɛʁ.mi.ˈne
extraordinaire	ɛk.stʁaoʁ.di.ˈnɛʁ
extrême	ɛk.ˈstʁɛm
extrêmement	ɛk.stʁɛ.ˈməm
exécuter	ɛg.ze.ky.ˈte
fable	fabl
fabrique	fa.ˈbʁik
fabriquer	fa.bʁi.ˈke
face	fas
facile	fa.ˈsil
facilement	fa.si.ˈləm
faciliter	fa.si.li.ˈte
facteur	fak.ˈtœʁ
facture	fak.ˈtyʁ
faculté	fa.kyl.ˈte
faible	fɛbl
faiblesse	fɛ.ˈblɛs
faiblesse de caractère	fɛ.blɛs.də.ka.ʁak.ˈtɛʁ
faim	fɛ̃
faire	fɛʁ
faire accepter	fɛ.ʁak.sɛp.ˈte
faire allusion	fɛ.ʁa.lyz.ˈjõ
faire appel	fɛ.ʁa.ˈpɛl
faire attention à	fɛ.ʁa.tã.ˈtjõa
faire avancer	fɛ.ʁa.vã.ˈse
faire banqueroute	fɛʁ.bã.kə.ˈʁut
faire cadeau	fɛʁ.ka.ˈdo
faire cesser	fɛʁ.sɛ.ˈse
faire cuire au four	fɛʁ.kɥi.ʁo.ˈfuʁ
faire du bruit	fɛʁ.dy.ˈbʁɥi
faire du bruit avec les lèvres	fɛʁ.dy.bʁɥia.vɛ.kle.ˈlɛvʁ
faire du jogging	fɛʁ.dy.ʒog.ˈʒɛ̃g
faire escale à	fɛ.ʁɛ.ska.ˈla
faire fondre	fɛʁ.ˈfõdʁ
faire glisser	fɛʁ.gli.ˈse
faire la cour	fɛʁ.la.ˈkuʁ
faire la noce	fɛʁ.la.ˈnɔs
faire les cent pas	fɛʁ.le.ˈspa
faire le courtage	fɛʁ.lə.kuʁ.ˈtaʒ
faire le malin	fɛʁ.lə.ma.ˈlɛ̃
faire l'acteur	fɛʁ.lak.ˈtœʁ
faire l'amour	fɛʁ.la.ˈmuʁ
faire naître	fɛʁ.ˈnɛtʁ
faire part de	fɛʁ.paʁ.ˈdə
faire paître	fɛʁ.ˈpɛtʁ
faire pipi	fɛʁ.pi.ˈpi
faire ses adieux	fɛʁ.sea.ˈdjø
faire son nid	fɛʁ.sõ.ˈni
faire tomber	fɛʁ.tõ.ˈbe
faire tournoyer	fɛʁ.tuʁ.nwa.ˈje
faire un bruit de succion	fɛ.ʁœ̃.bʁɥi.də.syk.ˈsjõ
faisan	fø.ˈzã
faiseur d'embarras	fɛ.zœʁ.dã.ba.ˈʁa
fait	fɛ
falaise	fa.ˈlɛz
falsifier	fal.si.ˈfje
fameux	fa.ˈmø
famille	fa.ˈmij
fanatique	fa.na.ˈtik
fanfarroner	fã.fa.ʁɔ.ˈne
fantaisie	fã.tɛ.ˈzi
fard	faʁ
farine	fa.ˈʁin
fatalité	fa.ta.li.ˈte
fatiguer	fa.ti.ˈge
fatigué	fa.ti.ˈge
faucher	fo.ˈʃe
faucon	fo.ˈkõ
fausser	fo.ˈse
fauteuil	fo.ˈtœj
faux	fo
favorable	fa.vo.ˈʁabl
favori	fa.vɔ.ˈʁi
faîte	fɛt
façade	fa.ˈsad
feldspath	fɛl.ˈspat
femelle	fə.ˈmɛl
femme	fam
femme de chambre	fam.də.ˈʃãbʁ
femme en travail	fam.tʁa.ˈvaj
fendre	fãdʁ
fenêtre	fə.ˈnɛtʁ
fer	fe
ferme	fɛʁm
fermer	fɛʁ.ˈme
fermer à clé	fɛʁ.mea.ˈkle
fermeture à glissière	fɛʁ.mə.ty.ʁa.gli.ˈsjɛʁ
fermier	fɛʁ.ˈmje
fermoir	fɛʁ.ˈmwaʁ
fervent	fɛʁv
ferveur	fɛʁ.ˈvœʁ
fer à repasser	fea.ʁə.pa.ˈse
fesse	fɛs
feu	fø
feuille	fœj
feuilleter	fœ.jə.ˈte
feuille de déclaration	fœj.də.de.kla.ʁa.ˈsjõ
feuille de placage	fœj.də.pla.ˈkaʒ
fiancé	fjã.ˈse
fiancée	fjã.ˈse
fiançailles	fjã.ˈsaj
fiche	fiʃ
fichier	fi.ˈʃje
fidélité	fi.de.li.ˈte
fidèle	fi.ˈdɛl
fiel	fjɛl
fier	fje
figue	fig
figuier	fig.ˈje
figure	fi.ˈgyʁ
fil	fil
file	fil
filet	fi.ˈlɛ
filiale	fi.ˈljal
fille	fij
filler la laine	fje.la.ˈlɛn
fille publique	fij.py.ˈblik
film	film
fils	fis
fils adoptif	fi.sa.dɔp.ˈtif
filtrer	fil.ˈtʁe
filtre à air	fil.ˈtʁaɛʁ
fin	fɛ̃
finalement	fi.na.ˈləm
finance	fi.ˈnãs
finir	fi.ˈniʁ
finlandais	fi.lã.ˈdɛ
finnois	fi.ˈnwa
fiord	fjɔʁ
fixe	fiks
fixer	fik.ˈse
fièvre	fjɛvʁ
flageller	fla.ʒɛ.ˈle
flairer	flɛ.ˈʁe
flamand	fla.ˈmã
flamber	flã.ˈbe
flamme	flam
flanc	flã
flatter	fla.ˈte
fleur	flœʁ
fleuve	flœv
fleuve Mackenzie	flœv.ma.kã.ˈzi
fleuve Yukon	flœ.vjy.ˈkõ
flirter	flœʁ.ˈte
flocon de neige	flo.kõ.də.ˈnɛʒ
florin	flɔ.ˈʁɛ̃
flot	flo
flotte	flɔt
flotter	flɔ.ˈte
flotte aérienne	flɔ.tae.ˈʁjɛn
fluor	flyɔʁ
fléau	fleo
fléchir	fle.ˈʃiʁ
flêche	flɛʃ
flûte	flyt
foi	fwa
foie	fwa
foin	fwɛ̃
foire	fwaʁ
foire agricole	fwa.ʁa.gʁi.ˈkɔl
fois	fwa
foncer	fõ.ˈse
fonction	fõk.ˈsjõ
fonctionnaire	fõk.sjɔ.ˈnɛʁ
fonctionner	fõk.sjɔ.ˈne
foncé	fõ.ˈse
fond	fõ
fondation	fõ.da.ˈsjõ
fonder	fõ.ˈde
fondre	fõdʁ
fonds	fõ
fontaine	fõ.ˈtɛn
foot	fɔo
football	fut.ˈbol
force	fɔʁs
forcer	fɔʁ.ˈse
forer	fɔ.ˈʁe
forger	fɔʁ.ˈʒe
forgeron	fɔʁ.ʒə.ˈʁõ
forme	fɔʁm
former	fɔʁ.ˈme
formidable	foʁ.mi.ˈdabl
formulaire	foʁ.my.ˈlɛʁ
formule	foʁ.ˈmyl
formuler	foʁ.my.ˈle
fort	fɔʁ
fortement	fɔʁ.ˈtəm
fortune	foʁ.ˈtyn
forum	fo.ˈʁɔm
forêt	fo.ˈʁɛ
forêt vierge	fo.ʁɛ.ˈvjɛʁʒ
fossé	fo.ˈse
fou	fu
foudre	fudʁ
fouet	fwɛ
fouetter	fwɛ.ˈte
fougère	fu.ˈʒɛʁ
fouiller	fu.ˈje
foule	ful
fouler aux pieds	fu.leo.ˈpje
four	fuʁ
fourchette	fuʁ.ˈʃɛt
fourmi	fuʁ.ˈmi
fourmiller	fuʁ.mi.ˈje
fourneau	fuʁ.ˈno
fournir	fuʁ.ˈniʁ
fourniture	fuʁ.ni.ˈtyʁ
fourrer	fu.ˈʁe
fourrure	fu.ˈʁyʁ
foutre	futʁ
foyer	fwa.ˈje
fracasser	fʁa.ka.ˈse
fraction	fʁak.ˈsjõ
fracture	fʁak.ˈtyʁ
fragile	fʁa.ˈʒil
fragment	fʁagm
frais	fʁɛ
fraise	fʁɛz
framboise	fʁã.ˈbwaz
franc	fʁã
francium	fʁã.ˈsjɔm
français	fʁã.ˈsɛ
frapper	fʁa.ˈpe
frauder	fʁo.ˈde
frein	fʁɛ̃
freiner	fʁɛ.ˈne
frein de secours	fʁɛ̃.də.sə.ˈkuʁ
frein de sûreté	fʁɛ̃.də.sy.ʁə.ˈte
friandise	fʁjã.ˈdiz
frire	fʁiʁ
friser	fʁi.ˈze
frisonne	fʁi.ˈzɔn
frisson	fʁi.ˈsõ
frivole	fʁi.ˈvɔl
froid	fʁwa
froisser	fʁwa.ˈse
fromage	fʁo.ˈmaʒ
froment	fʁɔm
front	fʁõ
frontière	fʁõ.ˈtjɛʁ
frotter	fʁɔ.ˈte
fruit	fʁɥi
fruitier	fʁɥi.ˈtje
fruit à coque	fʁɥia.ˈkɔk
fréquemment	fʁe.ˈkam
fréquent	fʁek
fréquenter	fʁe.kã.ˈte
frère	fʁɛʁ
frêne	fʁɛn
fuir	fɥiʁ
fuite	fɥit
fumer	fy.ˈme
fumier	fy.ˈmje
fumée	fy.ˈme
furieux	fy.ˈʁjø
fusil	fy.ˈzi
fusiller	fy.zi.ˈje
fusil à air comprimé	fy.ziaɛʁ.kõ.pʁi.ˈme
fusée	fy.ˈze
futilité	fy.ti.li.ˈte
futur	fy.ˈtyʁ
fécond	fe.ˈkõ
fédération	fe.de.ʁa.ˈsjõ
fée	fe
féliciter	fe.li.si.ˈte
féroce	fe.ˈʁɔs
février	fevʁ.ˈje
fève	fɛv
fête	fɛt
fêter	fɛ.ˈte
fôlatrer	fo.la.ˈtʁe
fût	fy
gagner	ga.ˈnje
gai	gɛ
gain	gɛ̃
gaine	gɛn
galerie	ga.lə.ˈʁi
galicien	ga.li.ˈsi
gallois	ga.ˈlwa
galoche	ga.ˈloʃ
galoper	ga.lɔ.ˈpe
gambader	gã.ba.ˈde
gamin	ga.ˈmɛ̃
gant	gã
garage	ga.ˈʁaʒ
garantir	ga.ʁã.ˈtiʁ
garde	gaʁd
garder	gaʁ.ˈde
gardien	gaʁ.ˈdi
gare	gaʁ
garer	ga.ˈʁe
garnir	gaʁ.ˈniʁ
garçon	gaʁ.ˈsõ
garçon de café	gaʁ.sõ.də.ka.ˈfe
gaspiller	ga.spi.ˈje
gauche	goʃ
gaufre	gofʁ
gaule	gol
gaulois	go.ˈlwa
gaz	gaz
gazette	ga.ˈzɛt
gazon	ga.ˈzõ
gazouiller	ga.zu.ˈje
gaz intestinale	ga.zɛ̃.tɛ.sti.ˈnal
gaélique	gae.ˈlik
gel	ʒɛl
geler	ʒə.ˈle
gelée	ʒə.ˈle
gencive	ʒã.ˈsiv
gendarme	ʒã.ˈdaʁm
gendre	ʒãdʁ
genou	ʒə.ˈnu
genre	ʒãʁ
gens	ʒ
gentil	ʒã.ˈti
genêt	ʒə.ˈnɛ
gerbe	ʒɛʁb
germain	ʒɛʁ.ˈmɛ̃
germanique	ʒɛʁ.ma.ˈnik
germe	ʒɛʁm
germer	ʒɛʁ.ˈme
geste	ʒɛst
ghanéen	ga.ˈne
gibbon	ʒi.ˈbõ
gigantesque	ʒi.gã.ˈtɛsk
gilet	ʒi.ˈlɛ
girafe	ʒi.ˈʁaf
giroflée des murailles	ʒi.ʁo.fle.de.my.ˈʁaj
gisement	ʒi.ˈzəm
gitan	ʒi.ˈtã
glace	glas
gland	glã
glaïeul	gla.ˈjœl
glissant	gli.ˈsã
glissant comme une anguille	gli.sã.kɔ.my.nã.ˈgij
glisser	gli.ˈse
glisser comme une anguille	gli.se.kɔ.my.nã.ˈgij
globe	glɔb
gloire	glwaʁ
glorieux	glɔ.ˈʁjø
glorifier	glɔ.ʁi.ˈfje
gnome	gnom
gnou	nju
golfe Persique	gɔlf.pɛʁ.ˈsik
gomme	gɔm
gonfler	gõ.ˈfle
goret	gɔ.ˈʁɛ
gorge	gɔʁʒ
gorille	gɔ.ˈʁij
gosse	gos
gothique	go.ˈtik
goudron	gu.ˈdʁõ
gouffre	gufʁ
goutte	gut
goutte d'eau	gut.ˈdo
gouvernail	gu.vɛʁ.ˈnaj
gouvernement	gu.vɛʁ.ˈnəm
gouverner	gu.vɛʁ.ˈne
goût	gu
goûter	gu.ˈte
gracieux	gʁa.ˈsjø
grade	gʁad
grain	gʁɛ̃
graine	gʁɛn
graisse	gʁɛs
grammaire	gʁa.ˈmɛʁ
gramme	gʁam
grand	gʁã
grandeur	gʁã.ˈdœʁ
grande personne	gʁãd.pɛʁ.ˈsɔn
grandiose	gʁã.ˈdjoz
grandir	gʁã.ˈdiʁ
grand lac des Esclaves	gʁã.lak.deɛ.ˈsklav
grand lac de l'Ours	gʁã.lak.də.ˈluʁ
granit	gʁa.ˈni
grappe	gʁap
gras	gʁa
gratitude	gʁa.ti.ˈtyd
gratter	gʁa.ˈte
grave	gʁav
graver	gʁa.ˈve
gravier	gʁa.ˈvje
gravir	gʁa.ˈviʁ
gravitation	gʁa.vi.ta.ˈsjõ
grec	gʁɛk
gredin	gʁə.ˈdɛ̃
grenouille	gʁə.ˈnuj
griffe	gʁif
griffer	gʁi.ˈfe
grille	gʁij
griller	gʁi.ˈje
grille d'aération	gʁij.dae.ʁa.ˈsjõ
grillon	gʁi.ˈjõ
grillé	gʁi.ˈje
grimper	gʁɛ̃.ˈpe
grincer	gʁɛ̃.ˈse
grippe	gʁip
gris	gʁi
grive	gʁiv
groenlandais	gʁœã.lã.ˈdɛ
grogner	gʁɔ.ˈnje
gronder	gʁõ.ˈde
gros	gʁo
groseille	gʁo.ˈzɛj
groseillier	gʁo.zɛ.ˈje
grossier	gʁo.ˈsje
grossir	gʁo.ˈsiʁ
grotte	gʁɔt
grouiller	gʁu.ˈje
groupe	gʁup
groupe de travail	gʁup.də.tʁa.ˈvaj
groënlandais	gʁo.lã.ˈdɛ
grue	gʁy
gré	gʁe
grève	gʁɛv
grâce	gʁas
grâce à	gʁa.ˈsa
grêle	gʁɛl
guatémaltèque	ga.te.mal.ˈtɛk
guerre	gɛʁ
guerroyer	gɛ.ʁwa.ˈje
guetter	gɛ.ˈte
gueule	gœl
gui	gi
guichet	gi.ˈʃɛ
guide	gid
guider	gi.ˈde
guignol	gi.ˈnjɔl
guillemet	gi.jə.ˈmɛ
guillemets	gi.jə.ˈmɛ
guinéen	gi.ˈne
guitare	gi.ˈtaʁ
guérir	ge.ˈʁiʁ
guêpe	gɛp
gymnastique	ʒim.na.ˈstik
gémir	ʒe.ˈmiʁ
génie	ʒe.ˈni
général	ʒe.ne.ˈʁal
génération	ʒe.ne.ʁa.ˈsjõ
généreux	ʒe.ne.ˈʁø
géographe	ʒeɔ.ˈgʁaf
géographie	ʒeɔ.gʁa.ˈfi
géographique	ʒeɔ.gʁa.ˈfik
géologie	ʒeɔ.lɔ.ˈʒi
géologique	ʒeɔ.lo.ˈʒik
géologue	ʒeɔ.ˈlɔg
géométrie	ʒeɔ.me.ˈtʁi
géorgien	ʒeɔʁ.ˈʒi
géranium	ʒe.ʁa.ˈnjɔm
gérant	ʒe.ˈʁã
gène	ʒɛn
gâcher	ga.ˈʃe
gâteau	ga.ˈto
gâter	ga.ˈte
gêner	ʒɛ.ˈne
gîte	ʒit
habile	a.ˈbil
habileté	a.bi.lə.ˈte
habilité	a.bi.li.ˈte
habiller	a.bi.ˈje
habit	a.ˈbi
habitant	a.bi.ˈtã
habitation	a.bi.ta.ˈsjõ
habiter	a.bi.ˈte
habitude	a.bi.ˈtyd
habituel	a.bi.ˈtyɛl
habituer	a.bi.ˈtye
hache	aʃ
hacher	a.ˈʃe
haie	ɛ
haleine	a.ˈlɛn
halte	alt
hameau	a.ˈmo
hameçon	a.mə.ˈsõ
hanche	ãʃ
hangar	ã.ˈgaʁ
hanneton	a.nə.ˈtõ
hardi	aʁ.ˈdi
hareng	aʁ
haricot	a.ʁi.ˈko
harmonieux	aʁ.mo.ˈnjø
harmonique	aʁ.mo.ˈnik
hasard	a.ˈzaʁ
hausser	o.ˈse
hausser les épaules	o.se.lee.ˈpol
haut	o
hauteur	o.ˈtœʁ
hawaiien	o.ˈwɛ
haïr	aiʁ
hebdomadairement	ɛb.dɔ.ma.dɛ.ˈʁəm
hectolitre	ɛk.tɔ.ˈlitʁ
hectomètre	ɛk.to.ˈmɛtʁ
hein	ɛ̃
hennir	ɛ.ˈniʁ
hente	ãt
herbe	ɛʁb
herser	ɛʁ.ˈse
heure	œʁ
heureusement	œ.ʁø.ˈzəm
heureux	œ.ˈʁø
heurter	œʁ.ˈte
hibou	i.ˈbu
hideux	i.ˈdø
hier	je
hier soir	je.ˈswaʁ
hindou	ɛ̃.ˈdu
hipothétique	i.pɔ.tɛ.ˈtik
hippopotame	i.pɔ.pɔ.ˈtam
hirondelle	i.ʁõ.ˈdɛl
hirsute	iʁ.ˈsyt
hispanique	i.spa.ˈnik
histoire	ist.ˈwaʁ
hiver	i.ˈve
homard	o.ˈmaʁ
hommage	ɔ.ˈmaʒ
homme	ɔm
homme de science	ɔm.də.ˈsjãs
hondurien	õ.dy.ˈʁi
hongrois	õ.ˈgʁwa
honneur	ɔ.ˈnœʁ
honnête	o.ˈnɛt
honorer	o.nɔ.ˈʁe
hop	ɔp
hoqueter	ɔ.kə.ˈte
horizon	o.ʁi.ˈzõ
horizontal	o.ʁi.zõ.ˈtal
horloge	ɔʁ.ˈlɔʒ
horloger	ɔʁ.lɔ.ˈʒe
hormis	ɔʁ.ˈmi
horoscope	o.ʁo.ˈskɔp
horreur	ɔ.ˈʁœʁ
horrible	ɔ.ˈʁibl
hors de	ɔʁ.ˈdə
hostile	o.ˈstil
houblon	u.ˈblõ
houe	u
houp	u
houx	u
huile	ɥil
huit	ɥi
humain	y.ˈmɛ̃
humble	ybl
humide	y.ˈmid
humilier	y.mi.ˈlje
humour	y.ˈmuʁ
humus	y.ˈmy
huppe	yp
hurler	yʁ.ˈle
hutte	yt
huître	ɥitʁ
hybride	i.ˈbʁid
hygiénique	iʒ.je.ˈnik
hygiène	iʒ.ˈjɛn
hymne	imn
hypnose	ip.ˈnoz
hypnotiser	ip.nɔ.ti.ˈze
hypocrite	i.po.ˈkʁit
hypothèque	i.po.ˈtɛk
hypothèse	i.po.ˈtɛz
hystérie	i.ste.ˈʁi
hystérique	i.ste.ˈʁik
hyène	jɛn
hébraïque	e.ˈbʁaik
hébreu	e.ˈbʁø
hélas	e.ˈla
hélice	e.ˈlis
hélium	e.ˈljɔm
hémorrhoïde	e.mɔ.ˈʁoid
hémorrhoïdes	e.mɔ.ˈʁoid
héraut	e.ˈʁo
hérisser	e.ʁi.ˈse
héritage	e.ʁi.ˈtaʒ
hériter	e.ʁi.ˈte
héron	e.ˈʁõ
héros	e.ˈʁo
héroïne	e.ˈʁɔin
héroïque	e.ˈʁɔik
héroïsme	e.ˈʁɔism
hérésie	e.ʁe.ˈzi
hésiter	e.zi.ˈte
hâte	at
hâter	a.ˈte
hâtif	a.ˈtif
hêtre	ɛtʁ
hôpital	o.pi.ˈtal
hôte	ot
hôtel	o.ˈtɛl
hôtel de ville	o.tɛl.də.ˈvil
hôtesse de l'air	o.tɛs.də.ˈlɛʁ
ibérien	i.be.ˈʁi
ibérique	i.be.ˈʁik
ibère	i.ˈbɛʁ
identifier	i.dã.ti.ˈfje
identique	i.dã.ˈtik
idiot	i.ˈdjo
idéal	i.ˈdeal
idée	i.ˈde
if	if
igname	i.ˈnjam
ignominie	i.njɔ.mi.ˈni
ignorer	i.njɔ.ˈʁe
ignoré	i.njɔ.ˈʁe
il	il
illettré	i.lɛ.ˈtʁe
illimité	i.li.mi.ˈte
illuminer	i.ly.mi.ˈne
illusion	i.lyz.ˈjõ
illustre	i.ˈlystʁ
illustrer	i.ly.ˈstʁe
ils	il
il paraît que	il.pa.ʁɛ.ˈkə
il y a	i.li.gʁɛ.ˈka
il y a ...	i.li.gʁɛ.ˈka
image	i.ˈmaʒ
imaginer	i.ma.ʒi.ˈne
imbroglio	ɛ̃.bʁogl.ˈjo
imbécile	ɛ̃.be.ˈsil
imiter	i.mi.ˈte
immense	i.ˈmãs
immerger	i.mɛʁ.ˈʒe
immeuble	i.ˈmœbl
immobile	i.mo.ˈbil
immoral	i.mo.ˈʁal
immédiat	i.me.ˈdja
immédiatement	i.me.dja.ˈtəm
impasse	ɛ̃.ˈpas
imperméable	ɛ̃.pɛʁ.ˈmeabl
impliquer	ɛ̃.pli.ˈke
implorer	ɛ̃.plɔ.ˈʁe
impoli	ɛ̃.pɔ.ˈli
importance	ɛ̃.pɔʁ.ˈtãs
important	ɛ̃.pɔʁ.ˈtã
importer	ɛ̃.pɔʁ.ˈte
imposant	ɛ̃.po.ˈzã
imposer	ɛ̃.po.ˈze
impossible	ɛ̃.po.ˈsibl
impression	ɛ̃.pʁɛ.ˈsjõ
imprimer	ɛ̃.pʁi.ˈme
imprimeur	ɛ̃.pʁi.ˈmœʁ
improviser	ɛ̃.pʁo.vi.ˈze
impulsion	ɛ̃.pyl.ˈsjõ
impérialisme	ɛ̃.pe.ʁja.ˈlism
impôt	ɛ̃.ˈpo
inattendu	i.na.tã.ˈdy
inattention	i.na.tã.ˈtjõ
inauguration	i.no.gy.ʁa.ˈsjõ
inaugurer	i.no.gy.ˈʁe
incalculable	ɛ̃.kal.ky.ˈlabl
incendie	ɛ̃.sã.ˈdi
incertain	ɛ̃.sɛʁ.ˈtɛ̃
inceste	ɛ̃.ˈsɛst
incitation	ɛ̃.si.ta.ˈsjõ
inciter	ɛ̃.si.ˈte
incliner	ɛ̃.kli.ˈne
inconnu	ɛ̃.ko.ˈny
inconvénient	ɛ̃.kõ.ve.ˈni
indication	ɛ̃.di.ka.ˈsjõ
indien	ɛ̃.ˈdi
indifférent	ɛ̃.di.ˈfeʁ
indigner	ɛ̃.di.ˈnje
indiquer	ɛ̃.di.ˈke
indispensable	ɛ̃.di.spã.ˈsabl
individu	ɛ̃.di.vi.ˈdy
indonésien	ɛ̃.do.ne.ˈzi
indulgent	ɛ̃.ˈdylʒ
industrie	ɛ̃.dy.ˈstʁi
industriel	ɛ̃.dy.stʁi.ˈjɛl
indépendant	ɛ̃.de.pã.ˈdã
ineluctable	i.nə.lyk.ˈtabl
inerte	i.ˈnɛʁt
infanterie	ɛ̃.fã.tə.ˈʁi
infecter	ɛ̃.fɛk.ˈte
infini	ɛ̃.fi.ˈni
infiniment	ɛ̃.fi.ˈnim
infirme	ɛ̃.ˈfiʁm
infirmier	ɛ̃.fiʁ.ˈmje
infirmière	ɛ̃.fiʁ.ˈmjɛʁ
influence	ɛ̃.ˈflyãs
influer	ɛ̃.ˈflye
informer	ɛ̃.fɔʁ.ˈme
inférieur	ɛ̃.fe.ˈʁjœʁ
ingrat	ɛ̃.ˈgʁa
ingénieur	ɛ̃.ʒe.ˈnjœʁ
injecter	ɛ̃.ʒɛk.ˈte
injure	ɛ̃.ˈʒyʁ
innocent	i.ˈnos
inné	i.ˈne
inondation	i.nõ.da.ˈsjõ
inonder	i.nõ.ˈde
inquiet	ɛ̃.ˈkjɛ
inscription	ɛ̃.skʁips.ˈjõ
inscrire	ɛ̃.ˈskʁiʁ
insecte	ɛ̃.ˈsɛkt
insigne	ɛ̃.ˈsinj
insinuer	ɛ̃.si.ˈnye
insister	ɛ̃.si.ˈste
inspecter	ɛ̃.spɛk.ˈte
inspecteur	ɛ̃.spɛk.ˈtœʁ
inspirer	ɛ̃.spi.ˈʁe
installer	ɛ̃.sta.ˈle
instance	ɛ̃.ˈstãs
instances	ɛ̃.ˈstãs
instant	ɛ̃.ˈstã
instinct	ɛ̃.ˈstɛ̃
institut	ɛ̃.sti.ˈty
instituteur	ɛ̃.sti.ty.ˈtœʁ
institutrice	ɛ̃.sti.ty.ˈtʁis
instruction	ɛ̃.stʁyk.ˈsjõ
instruire	ɛ̃stʁ.ˈɥiʁ
instrument	ɛ̃.ˈstʁym
insuffisance	ɛ̃.sy.fi.ˈzãs
insuffisant	ɛ̃.sy.fi.ˈzã
insulter	ɛ̃.syl.ˈte
intact	ɛ̃.ˈtakt
intellectuel	ɛ̃.tɛ.lɛk.ˈtyɛl
intelligence	ɛ̃.tɛ.li.ˈʒãs
intelligent	ɛ̃.tɛ.ˈliʒ
intendance	ɛ̃.tã.ˈdãs
intense	ɛ̃.ˈtãs
intention	ɛ̃.tã.ˈtjõ
interdire	ɛ̃.tɛʁ.ˈdiʁ
interface	ɛ̃.tɛʁ.ˈfas
interjection	ɛ̃.tɛʁ.ʒɛk.ˈsjõ
interminable	ɛ̃.tɛʁ.mi.ˈnabl
intermédaire	ɛ̃.tɛʁ.me.ˈdɛʁ
intermédiaire	ɛ̃.tɛʁ.me.ˈdjɛʁ
international	ɛ̃.tɛʁ.na.sjo.ˈnal
interne	ɛ̃.ˈtɛʁn
interpeller	ɛ̃.tɛʁ.pɛ.ˈle
interpréter	ɛ̃.tɛʁ.pʁɛ.ˈte
interprète	ɛ̃.tɛʁ.ˈpʁɛt
interroger	ɛ̃.tɛ.ʁɔ.ˈʒe
interrompre	ɛ̃.tɛ.ˈʁõpʁ
interrupteur	ɛ̃.tɛ.ʁyp.ˈtœʁ
interruption	ɛ̃.tɛ.ʁyps.ˈjõ
intervalle	ɛ̃.tɛʁ.ˈval
intervenir	ɛ̃.tɛʁ.və.ˈniʁ
interview	ɛ̃.tɛʁ.ˈvju
interéssant	ɛ̃.tə.ʁe.ˈsã
intestin	ɛ̃.tɛ.ˈstɛ̃
intime	ɛ̃.ˈtim
intitulé	ɛ̃.ti.ty.ˈle
intriger	ɛ̃.tʁi.ˈʒe
intrigue	ɛ̃.ˈtʁig
intriguer	ɛ̃.tʁi.ˈge
introduction	ɛ̃.tʁo.dyk.ˈsjõ
introduire	ɛ̃.tʁo.ˈdɥiʁ
intéressant	ɛ̃.te.ʁe.ˈsã
intéresser	ɛ̃.te.ʁe.ˈse
intérieur	ɛ̃.te.ˈʁjœʁ
intérêt	ɛ̃.te.ˈʁɛ
inutile	i.ny.ˈtil
invariable	ɛ̃.va.ˈʁjabl
invasion	ɛ̃.vaz.ˈjõ
inventer	ɛ̃.vã.ˈte
invention	ɛ̃.vã.ˈtjõ
inverse	ɛ̃.ˈvɛʁs
investir	ɛ̃.vɛ.ˈstiʁ
invitation	ɛ̃.vi.ta.ˈsjõ
inviter	ɛ̃.vi.ˈte
invoquer	ɛ̃.vɔ.ˈke
invraisemblable	ɛ̃.vʁɛ.sã.ˈblabl
inédit	i.ne.ˈdi
iode	jɔd
irakien	i.ʁa.ˈki
iranien	i.ʁa.ˈni
iris	i.ˈʁi
irlandais	iʁ.lã.ˈdɛ
ironie	i.ʁo.ˈni
irriter	i.ʁi.ˈte
islam	is.ˈlam
islandais	is.lã.ˈdɛ
isoler	i.zɔ.ˈle
issue	i.ˈsy
italien	i.ta.ˈli
itinéraire	i.ti.ne.ˈʁɛʁ
ivoire	i.ˈvwaʁ
ivre	ivʁ
ivresse	i.ˈvʁɛs
jadis	ʒa.ˈdi
jaillir	ʒa.ˈjiʁ
jaloux	ʒa.ˈlu
jamais	ʒa.ˈmɛ
jambe	ʒãb
jambon	ʒã.ˈbõ
janvier	ʒã.ˈvje
japonais	ʒa.pɔ.ˈnɛ
jardin	ʒaʁ.ˈdɛ̃
jardinage	ʒaʁ.di.ˈnaʒ
jardinier	ʒaʁ.di.ˈnje
jaser	ʒa.ˈze
jaune	ʒon
javanais	ʒa.va.ˈnɛ
je	ʒə
jeter	ʒə.ˈte
jeu	ʒø
jeudi	ʒø.ˈdi
jeune	ʒœn
jeune fille	ʒœn.ˈfij
jeûner	ʒø.ˈne
je vous demande pardon	ʒə.vu.də.mãd.paʁ.ˈdõ
joie	ʒwa
joindre	ʒwɛ̃dʁ
joint	ʒwɛ̃
joli	ʒɔ.ˈli
joncher	ʒõ.ˈʃe
jonc odorant	ʒõɔ.dɔ.ˈʁã
jongler	ʒõ.ˈgle
joue	ʒu
jouer	ʒue
jouir	ʒwiʁ
jouir de	ʒwiʁ.ˈdə
jour	ʒuʁ
journal	ʒuʁ.ˈnal
journalier	ʒuʁ.na.ˈlje
journaliste	ʒuʁ.na.ˈlist
journellement	ʒuʁ.nɛ.ˈləm
journée	ʒuʁ.ˈne
jour de l'an	ʒuʁ.də.ˈlã
jour férié	ʒuʁ.fe.ˈʁje
joyeux	ʒwa.ˈjø
juge	ʒyʒ
jugement	ʒy.ˈʒəm
juger	ʒy.ˈʒe
juillet	ʒɥi.ˈjɛ
juin	ʒɥɛ̃
jumeau	ʒy.ˈmo
jumeaux	ʒy.ˈmo
jumelles	ʒy.ˈmɛl
jungle	ʒygl
jupe	ʒyp
jurer	ʒy.ˈʁe
jus	ʒy
jusqu'à	ʒy.ˈska
juste	ʒyst
justement	ʒy.ˈstəm
j'	ʒ
kenyan	kə.ˈniã
kermesse	kɛʁ.ˈmɛs
khmer	kme
kilobyte	ki.lo.ˈbit
kilogramme	ki.lo.ˈgʁam
kilomètre	ki.lo.ˈmɛtʁ
kimono	ki.mo.ˈno
kiosque	kjɔsk
krypton	kʁip.ˈtõ
kurde	kyʁd
la	la
laboratoire	la.bo.ʁa.ˈtwaʁ
laborieux	la.bɔ.ˈʁjø
labourer	la.bu.ˈʁe
laboureur	la.bu.ˈʁœʁ
lac	lak
lacet	la.ˈsɛ
lacs de la Frontière	lak.də.la.fʁõ.ˈtjɛʁ
lac Athabasca	la.ka.ta.ba.ˈska
lac Champlain	lak.ʃã.ˈplɛ̃
lac Clarice	lak.kla.ˈʁis
lac Donquan	lak.dõ.ˈkã
lac Fonteneau	lak.fõ.tə.ˈno
lac Gaillot	lak.ga.ji.ˈjo
lac Holden	la.kɔl.ˈdɛn
lac Huron	la.ky.ˈʁõ
lac Kingroy	lak.kɛ̃.ˈgʁwaj
lac Labyrinthe	la.kla.bi.ˈʁɛ̃t
lac Mabille	lak.ma.ˈbij
lac Michigan	lak.mi.ʃi.ˈgã
lac Nipigon	lak.ni.pi.ˈgõ
lac Norman	lak.nɔʁ.ˈman
lac Ontario	la.kõ.ta.ˈʁjo
lac Ross	la.ˈkʁos
lac Supérieur	lak.sy.pe.ˈʁjœʁ
lac Sénécal	lak.se.ne.ˈkal
lac Témiscamingue	lak.te.mi.ska.ˈmɛ̃g
lac Winnipeg	la.kwi.ni.ˈpə
lac aux Allumettes	la.koa.ly.ˈmɛt
lac des Bois	lak.de.ˈbwa
lac des Marets	lak.de.ma.ˈʁɛ
lac à la Pluie	la.ka.lapl.ˈɥi
lagune	la.ˈgyn
laid	lɛ
laine	lɛn
laisser	lɛ.ˈse
lait	lɛ
laiton	lɛ.ˈtõ
laitue	lɛ.ˈty
lambeau	lã.ˈbo
lambris	lã.ˈbʁi
lame	lam
lamentable	la.mã.ˈtabl
lame tranchante	lam.tʁã.ˈʃãt
lamier	la.ˈmje
lampe	lãp
lancer	lã.ˈse
langage	lã.ˈgaʒ
langue	lãg
langue allemande	lã.ga.lə.ˈmãd
langue anglaise	lã.gã.ˈglɛz
langue espagnole	lã.gɛ.spa.ˈnjɔl
langue française	lãg.fʁã.ˈsɛz
langue gaélique	lãg.gae.ˈlik
langue hawaiienne	lã.go.wɛi.ˈjɛn
langue hébraïque	lã.ge.ˈbʁaik
langue japonaise	lãg.ʒa.pɔ.ˈnɛz
langue portugaise	lãg.pɔʁ.ty.ˈgɛz
langue russe	lã.ˈgʁys
langue tchèque	lãg.ˈtʃɛk
lanière	la.ˈnjɛʁ
lanterne	lã.ˈtɛʁn
laotien	laɔ.ˈti
lapin	la.ˈpɛ̃
lapon	la.ˈpõ
lard	laʁ
large	laʁʒ
largement	laʁ.ˈʒəm
largeur	laʁ.ˈʒœʁ
larme	laʁm
larve	laʁv
las	la
lasser	la.ˈse
latin	la.ˈtɛ̃
laurier	lo.ˈʁje
lavande	la.ˈvãd
laver	la.ˈve
laïc	laik
laïque	laik
la Manche	la.ˈmãʃ
le	lə
lecteur	lɛk.ˈtœʁ
lent	l
lentement	lã.ˈtəm
lentille	lã.ˈtij
les	le
lessive	lɛ.ˈsiv
lest	lɛst
les deux	le.ˈdø
letton	lɛ.ˈtõ
lettre	lɛtʁ
lettre de créance	lɛtʁ.də.ˈkʁeãs
lettre de recommandation	lɛtʁ.də.ʁə.ko.mã.da.ˈsjõ
lettre de relance	lɛtʁ.də.ʁə.ˈlãs
lettre recommandée	lɛtʁ.ʁə.ko.mã.ˈde
leur	lœʁ
lever	lə.ˈve
levier	lə.ˈvje
leçon	lə.ˈsõ
le matin	lə.ma.ˈtɛ̃
le mieux	lə.ˈmjø
le néant	lə.ˈneã
le plus	lə.ˈply
le soir	lə.ˈswaʁ
libanais	li.ba.ˈnɛ
libellule	li.bɛ.ˈlyl
liber	li.ˈbe
liberté	li.bɛʁ.ˈte
libraire	li.ˈbʁɛʁ
librairie	li.bʁɛ.ˈʁi
libyen	li.ˈbi
libérer	li.be.ˈʁe
libérien	li.be.ˈʁi
licence	li.ˈsãs
licencier	li.sã.ˈsje
lien	li
lier	lje
lierre	ljɛʁ
lieu	ljø
lieue	ljø
lieutenant	ljø.tə.ˈnã
ligne	linj
ligue	lig
lilas	li.ˈla
limace	li.ˈmas
limaçon	li.ma.ˈsõ
lime	lim
limer	li.ˈme
limite	li.ˈmit
limiter	li.mi.ˈte
limpide	lɛ̃.ˈpid
lin	lɛ̃
linge	lɛ̃ʒ
lion	ljõ
liquide	li.ˈkid
liquider	li.ki.ˈde
lire	liʁ
lis	lis
liseron	li.zə.ˈʁõ
lisière	liz.ˈjɛʁ
lisse	lis
liste	list
liste de candidats	list.də.kã.di.ˈda
liste de présentation	list.də.pʁe.zã.ta.ˈsjõ
liste d'adresses	list.da.ˈdʁɛs
lis des marais	lis.de.ma.ˈʁɛ
lit	li
lithium	li.ˈtiɔm
litre	litʁ
littéralement	li.te.ʁa.ˈləm
littérature	li.te.ʁa.ˈtyʁ
lit d'accouchement	li.da.ku.ˈʃəm
livonien	li.vo.ˈni
livre	livʁ
livrer	li.ˈvʁe
liège	ljɛʒ
lièvre	ljɛvʁ
local	lo.ˈkal
localité	lo.ka.li.ˈte
locataire	lo.ka.ˈtɛʁ
locomotive	lɔ.kɔ.mɔ.ˈtiv
locution	lo.ky.ˈtjõ
logement	lɔ.ˈʒəm
loger	lɔ.ˈʒe
logique	lo.ˈʒik
logis	lo.ˈʒi
loi	lwa
loin	lwɛ̃
lointain	lwɛ̃.ˈtɛ̃
loisirs	lwa.ˈziʁ
lombes	lõb
lombric	lõ.ˈbʁik
long	lõ
longtemps	lõ.ˈtã
longuement	lõ.ˈgəm
longueur	lõ.ˈgœʁ
lors	lɔʁ
lorsque	loʁsk
loterie	lo.tə.ˈʁi
louange	luãʒ
loucher	lu.ˈʃe
louer	lue
loup	lu
loupe	lup
lourd	luʁ
lourdement	luʁ.ˈdəm
louve	luv
loyal	lwa.ˈjal
loyer	lwa.ˈje
lubie	ly.ˈbi
lucarne	ly.ˈkaʁn
lui	lɥi
luire	lɥiʁ
luisant	lɥi.ˈzã
lumineux	ly.mi.ˈnø
lumière	ly.ˈmjɛʁ
lundi	ly.ˈdi
lune	lyn
lunette	ly.ˈnɛt
lunettes	ly.ˈnɛt
lupanar	ly.pa.ˈnaʁ
lupine	ly.ˈpin
luter	ly.ˈte
luth	lyt
lutin	ly.ˈtɛ̃
lutter	ly.ˈte
luxe	lyks
luxembourgeois	lyk.sã.buʁ.ˈʒwa
lycée	li.ˈse
lynx	lɛ̃ks
lyre	liʁ
l'	l
l'une et l'autre	ly.ne.ˈlotʁ
l'un et l'autre	lye.ˈlotʁ
lécher	le.ˈʃe
léger	le.ˈʒe
légerement	le.ʒə.ˈʁəm
légitime	le.ʒi.ˈtim
légume	le.ˈgym
léopard	leɔ.ˈpaʁ
lézard	le.ˈzaʁ
lèvre	lɛvʁ
lâche	laʃ
lâcher	la.ˈʃe
lâcheté	la.ʃə.ˈte
ma	ma
machine	ma.ˈʃin
machine administrative	ma.ʃi.nad.mi.ni.stʁa.ˈtiv
machine à adresser	ma.ʃi.naa.dʁɛ.ˈse
machine à écrire	ma.ʃi.nae.ˈkʁiʁ
macédonien	ma.se.do.ˈni
madame	ma.ˈdam
mademoiselle	ma.də.mwa.ˈzɛl
maestro	mɛɛ.ˈstʁo
magasin	ma.ga.ˈzɛ̃
magie	ma.ˈʒi
magique	ma.ˈʒik
magnifique	ma.nji.ˈfik
magnésium	ma.njez.ˈjɔm
magnétophone	ma.njɛ.to.ˈfɔn
magnétoscope	ma.njɛ.to.ˈskɔp
mai	mɛ
maigre	mɛgʁ
maille	maj
maillet	ma.ˈjɛ
maillot de bain	ma.jo.də.ˈbɛ̃
maillot de corps	ma.jo.də.ˈkɔʁ
main	mɛ̃
maint	mɛ̃
maintenant	mɛ̃.tə.ˈnã
maintenir	mɛ̃.tə.ˈniʁ
maire	mɛʁ
mais	mɛ
maison	mɛ.ˈzõ
maison close	mɛ.zõ.ˈkloz
maison de repos	mɛ.zõ.də.ʁə.ˈpo
maitriser	mɛ.tʁi.ˈze
majesté	ma.ʒɛ.ˈste
majeur	ma.ˈʒœʁ
majorité	ma.ʒɔ.ʁi.ˈte
majuscule	ma.ʒy.ˈskyl
mal	mal
malade	ma.ˈlad
maladroit	ma.la.ˈdʁwa
malais	ma.ˈlɛ
malaisien	ma.lɛ.ˈzi
malard	ma.ˈlaʁ
malaria	ma.la.ˈʁja
malentendu	ma.lã.tã.ˈdy
malgré	mal.ˈgʁe
malheureusement	ma.lœ.ʁø.ˈzəm
malheureux	ma.lœ.ˈʁø
malin	ma.ˈlɛ̃
malle	mal
malsain	mal.ˈsɛ̃
maltais	mal.ˈtɛ
maltraiter	mal.tʁɛ.ˈte
mal de l'air	mal.də.ˈlɛʁ
mal de mer	mal.də.ˈme
maman	ma.ˈmã
mamelle	ma.ˈmɛl
mamelon	ma.mə.ˈlõ
mammifère	ma.mi.ˈfɛʁ
manche	mãʃ
manchette	mã.ˈʃɛt
mandarine	mã.da.ˈʁin
mandat	mã.ˈda
mandchou	mãd.ˈʃu
manie	ma.ˈni
manier	ma.ˈnje
manifestation	ma.ni.fɛ.sta.ˈsjõ
manifester	ma.ni.fɛ.ˈste
maniéré	ma.nje.ˈʁe
manière	ma.ˈnjɛʁ
manière d'être	ma.njɛʁ.ˈdɛtʁ
manne	man
manque	mãk
manquer	mã.ˈke
mansarde	mã.ˈsaʁd
manteau	mã.ˈto
maquereau	ma.kə.ˈʁo
maquillage	ma.ki.ˈjaʒ
maquiller	ma.ki.ˈje
marais	ma.ˈʁɛ
marbre	maʁbʁ
marchand	maʁ.ˈʃã
marchander	maʁ.ʃã.ˈde
marchandise	maʁ.ʃã.ˈdiz
marche	maʁʃ
marcher	maʁ.ˈʃe
marcher dans l'eau	maʁ.ʃe.dã.ˈlo
marcher sur	maʁ.ʃe.ˈsyʁ
marché	maʁ.ˈʃe
mardi	maʁ.ˈdi
marge	maʁʒ
marguerite	maʁ.gə.ˈʁit
mari	ma.ˈʁi
mariage	ma.ˈʁjaʒ
marier	ma.ˈʁje
marin	ma.ˈʁɛ̃
marionnette	ma.ʁjo.ˈnɛt
marié	ma.ˈʁje
mariée	ma.ˈʁje
mariés	ma.ˈʁje
mari et femme	ma.ʁie.ˈfam
mark	maʁk
marocain	ma.ʁo.ˈkɛ̃
marque	maʁk
marquer	maʁ.ˈke
marron	ma.ˈʁõ
marronnier	ma.ʁɔ.ˈnje
mars	maʁ
marsouin	maʁ.ˈswɛ̃
marte	maʁt
marteau	maʁ.ˈto
martre	maʁtʁ
martyr	maʁ.ˈtiʁ
martyre	maʁ.ˈtiʁ
marécage	ma.ʁe.ˈkaʒ
marée	ma.ˈʁe
marée basse	ma.ʁe.ˈbas
marée haute	ma.ˈʁeot
masque	mask
massacrer	ma.sa.ˈkʁe
masse	mas
masser	ma.ˈse
massif	ma.ˈsif
massif de montagnes	ma.sif.də.mõ.ˈtagn
matelas	ma.tə.ˈla
mathématique	ma.te.ma.ˈtik
mathématiques	ma.te.ma.ˈtik
matin	ma.ˈtɛ̃
matinée	ma.ti.ˈne
matière	ma.ˈtjɛʁ
matière plastique	ma.tjɛʁ.pla.ˈstik
matériau	ma.te.ˈʁjo
matériel	ma.te.ˈʁjɛl
maudire	mo.ˈdiʁ
maure	moʁ
mauritanien	mo.ʁi.ta.ˈni
maussade	mo.ˈsad
mauvais	mo.ˈvɛ
maximum	mak.si.ˈmɔm
maïs	mais
maître	mɛtʁ
maîtresse	mɛ.ˈtʁɛs
maçon	ma.ˈsõ
maçonner	ma.sɔ.ˈne
me	mə
meilleur	mɛ.ˈjœʁ
melon	mə.ˈlõ
melon d'eau	mə.lõ.ˈdo
membre	mãbʁ
menace	mə.ˈnas
menacer	mə.na.ˈse
mendiant	mã.ˈdjã
mendier	mã.ˈdje
mener	mə.ˈne
mensonge	mã.ˈsõʒ
mensuel	mã.ˈsyɛl
mensuellement	mã.syɛ.ˈləm
mental	mã.ˈtal
menthe	mãt
mentionner	mã.sjɔ.ˈne
mentir	mã.ˈtiʁ
menton	mã.ˈtõ
menu	mə.ˈny
mer	me
merci	mɛʁ.ˈsi
mercredi	mɛʁ.kʁə.ˈdi
mercure	mɛʁ.ˈkyʁ
merle	mɛʁl
merveilleux	mɛʁ.vɛ.ˈjø
mer Adriatique	meadʁ.ja.ˈtik
mer Baltique	me.bal.ˈtik
mer Caspienne	me.kasp.ˈjɛn
mer Egée	meɛ.ˈʒe
mer Tyrrhénienne	me.ti.ʁe.ni.ˈjɛn
mer de Beaufort	me.də.bo.ˈfɔʁ
mer du Labrador	me.dy.la.bʁa.ˈdɔʁ
mer du Nord	me.dy.ˈnɔʁ
mer d'Irlande	me.diʁ.ˈlãd
mes	me
message	mɛ.ˈsaʒ
messager	mɛ.sa.ˈʒe
mesure	mə.ˈzyʁ
mesurer	mə.zy.ˈʁe
mesure de largeur	mə.zyʁ.də.laʁ.ˈʒœʁ
mettre	mɛtʁ
mettre au monde	mɛ.tʁo.ˈmõd
mettre d'accord	mɛtʁ.da.ˈkɔʁ
mettre en adjudication	mɛ.tʁad.ʒy.di.ka.ˈsjõ
mettre en place de	mɛtʁ.plas.ˈdə
mettre à l'entreprise	mɛ.tʁa.lã.tʁə.ˈpʁiz
meuble	mœbl
meubler	mœ.ˈble
meunier	mœ.ˈnje
meurtrier	mœʁ.ˈtʁje
mexicain	mɛk.si.ˈkɛ̃
mica	mi.ˈka
microbe	mi.ˈkʁɔb
micromètre	mi.kʁo.ˈmɛtʁ
microsillon	mi.kʁo.si.ˈjõ
midi	mi.ˈdi
miel	mjɛl
miette	mjɛt
mieux	mjø
mignon	mi.ˈnjõ
milan	mi.ˈlã
milieu	mi.ˈljø
militaire	mi.li.ˈtɛʁ
mille	mil
millimètre	mi.li.ˈmɛtʁ
minauderie	mi.no.də.ˈʁi
mince	mɛ̃s
mine	min
miner	mi.ˈne
minerai	mi.nə.ˈʁɛ
mineur	mi.ˈnœʁ
minimum	mi.ni.ˈmɔm
miniscule	mi.ni.ˈskyl
ministre	mi.ˈnistʁ
ministère	mi.ni.ˈstɛʁ
minorité	mi.no.ʁi.ˈte
minuscule	mi.ny.ˈskyl
minute	mi.ˈnyt
minéral	mi.ne.ˈʁal
miracle	mi.ˈʁakl
miroir	mi.ˈʁwaʁ
mission	mi.ˈsjõ
missionnaire	mi.sjɔ.ˈnɛʁ
misérable	mi.ze.ˈʁabl
misère	mi.ˈzɛʁ
mite	mit
mobile	mo.ˈbil
mobilier	mo.bi.ˈlje
mode	mɔd
modeler	mo.də.ˈle
moderne	mo.ˈdɛʁn
modeste	mo.ˈdɛst
modestie	mo.dɛ.ˈsti
modifier	mo.di.ˈfje
modiste	mo.ˈdist
modéré	mo.de.ˈʁe
modèle	mo.ˈdɛl
moi	mwa
moine	mwan
moineau	mwa.ˈno
moins	mwɛ̃
mois	mwa
moisi	mwa.ˈzi
moisir	mwa.ˈziʁ
moisson	mwa.ˈsõ
moitié	mwa.ˈtje
moldave	mɔl.ˈdav
mollet	mo.ˈlɛ
moluquois	mɔ.ly.ˈkwa
moment	mɔm
mon	mõ
monde	mõd
monnaie	mo.ˈnɛ
monopoliser	mo.no.pɔ.li.ˈze
monotone	mo.no.ˈtɔn
monseigneur	mõ.sɛ.ˈnjœʁ
monstre	mõstʁ
mont	mõ
montage	mõ.ˈtaʒ
montagne	mõ.ˈtagn
montagnes Rocheuses	mõ.tagn.ʁo.ˈʃøz
montant	mõ.ˈtã
monter	mõ.ˈte
monter à bicyclette	mõ.tea.bi.si.ˈklɛt
monter à cheval	mõ.tea.ʃə.ˈval
monter à l'abordage	mõ.tea.la.bɔʁ.ˈdaʒ
montre	mõtʁ
montrer	mõ.ˈtʁe
monts Torngat	mõ.tɔʁ.ˈga
monténégrin	mõ.te.ne.ˈgʁɛ̃
mont Cervin	mõ.sɛʁ.ˈvɛ̃
mont d'Iberville	mõ.di.bɛʁ.ˈvil
monument	mo.ˈnym
monégasque	mo.ne.ˈgask
moral	mo.ˈʁal
morale	mo.ˈʁal
morceau	mɔʁ.ˈso
mordre	mɔʁdʁ
morne	mɔʁn
morphine	mɔʁ.ˈfin
morpion	mɔʁ.ˈpjõ
mort	mɔʁ
mortel	mɔʁ.ˈtɛl
mortier	mɔʁ.ˈtje
morue	mɔ.ˈʁy
moscovite	mo.sko.ˈvit
mosquée	mo.ˈske
mot	mo
moteur	mo.ˈtœʁ
motif	mɔ.ˈtif
motion	mɔ.ˈtjõ
moto	mo.ˈto
mou	mu
mouche	muʃ
mouchoir	mu.ˈʃwaʁ
moudre	mudʁ
mouette	mwɛt
mouiller	mu.ˈje
moule	mul
mourir	mu.ˈʁiʁ
mousquet	mu.ˈskɛ
mousse	mus
moustache	mu.ˈstaʃ
moustique	mu.ˈstik
moutarde	mu.ˈtaʁd
mouton	mu.ˈtõ
mouvement	mu.ˈvəm
mouvoir	mu.ˈvwaʁ
moyen	mwaj
moyenne	mwa.ˈjɛn
moyeu	mwa.ˈjø
muet	myɛ
mugir	my.ˈʒiʁ
muguet	my.ˈgɛ
mulet	my.ˈlɛ
multicolore	myl.ti.kɔ.ˈlɔʁ
multiple	myl.ˈtipl
multitude	myl.ti.ˈtyd
munir	my.ˈniʁ
munitions	my.ni.ˈsjõ
mur	myʁ
murmure	myʁ.ˈmyʁ
murmurer	myʁ.my.ˈʁe
muscle	myskl
muselière	my.zə.ˈljɛʁ
musicien	my.zi.ˈsi
musique	my.ˈzik
musée	my.ˈze
mutiler	my.ti.ˈle
mutilé	my.ti.ˈle
myope	mjɔp
myosotis	mjo.zɔ.ˈti
myriapode	mi.ʁja.ˈpɔd
myrrhe	miʁ
myrtille	miʁ.ˈtij
mysticisme	mi.sti.ˈsism
mystification	mi.sti.fi.ka.ˈsjõ
mystifier	mi.sti.ˈfje
mystique	mi.ˈstik
mystérieux	mi.ste.ˈʁjø
mystère	mi.ˈstɛʁ
mythe	mit
mythique	mi.ˈtik
mythologie	mi.to.lo.ˈʒi
mythologue	mi.to.ˈlɔg
myxomatose	mik.sɔ.ma.ˈtoz
m'	m
mécanicien	me.ka.ni.ˈsi
mécanicien aéronautique	me.ka.ni.siae.ʁo.no.ˈtik
mécanique	me.ka.ˈnik
méchant	me.ˈʃã
méconnaître	me.kɔ.ˈnɛtʁ
mécontent	me.ˈkõt
médaille	me.ˈdaj
médecin	me.də.ˈsɛ̃
méditer	me.di.ˈte
méduse	me.ˈdyz
méfiance	me.ˈfjãs
méfiant	me.ˈfjã
mégère	me.ˈʒɛʁ
mélancolie	me.lã.kɔ.ˈli
mélancolique	me.lã.kɔ.ˈlik
mélange	me.ˈlãʒ
mélanger	me.lã.ˈʒe
mélanésien	me.la.ne.ˈzi
mélodie	me.lɔ.ˈdi
mélèze	me.ˈlɛz
mémoire	me.ˈmwaʁ
ménager	me.na.ˈʒe
mépriser	me.pʁi.ˈze
mérite	me.ˈʁit
mériter	me.ʁi.ˈte
mésange	me.ˈzãʒ
métal	me.ˈtal
métamorphose	me.ta.mɔʁ.ˈfoz
méthode	me.ˈtɔd
métier	me.ˈtje
métro	me.ˈtʁo
mèche	mɛʃ
mère	mɛʁ
mètre	mɛtʁ
mâcher	ma.ˈʃe
mâchoire	ma.ˈʃwaʁ
mâle	mal
mât	ma
mêler	mɛ.ˈle
même	mɛm
mûr	myʁ
mûre sauvage	myʁ.so.ˈvaʒ
mûrier	my.ˈʁje
mûrir	my.ˈʁiʁ
nageoire	na.ˈʒwaʁ
nager	na.ˈʒe
nain	nɛ̃
naissance	nɛ.ˈsãs
napolitain	na.pɔ.li.ˈtɛ̃
nappe	nap
nappe de table	nap.də.ˈtabl
narcisse	naʁ.ˈsis
nation	na.ˈsjõ
national	na.sjo.ˈnal
natter	na.ˈte
nature	na.ˈtyʁ
naturel	na.ty.ˈʁɛl
naturellement	na.ty.ʁɛ.ˈləm
naufrage	no.ˈfʁaʒ
navet	na.ˈvɛ
naviguer	na.vi.ˈge
navire	na.ˈviʁ
naïf	naif
naître	nɛtʁ
necessaire	nə.sɛ.ˈsɛʁ
neige	nɛʒ
neiger	nɛ.ˈʒe
nerf	nɛʁ
nerveux	nɛʁ.ˈvø
net	nɛt
neuf	nœf
neutre	nøtʁ
neveu	nə.ˈvø
nez	ne
nez aquilin	nea.ki.ˈlɛ̃
ne ... guère	nə.ˈgɛʁ
ne ... jamais	nə.ʒa.ˈmɛ
ne ... nullement	nə.ny.ˈləm
ne ... pas	nə.ˈpa
ne ... plus	nə.ˈply
ne ... que	nə.ˈkə
ne pas s'éteindre	nə.pa.se.ˈtɛ̃dʁ
nicaraguayen	ni.ka.ʁa.ˈgɛj
niche	niʃ
nicher	ni.ˈʃe
nickel	ni.ˈkɛl
nid	ni
nier	nje
nigérian	ni.ʒe.ˈʁjã
nigérien	ni.ʒe.ˈʁi
niveau	ni.ˈvo
nièce	njɛs
ni ... ni	ni.ˈni
noble	nɔbl
noce	nɔs
noir	nwaʁ
noisette	nwa.ˈzɛt
noix	nwa
nom	nõ
nombre	nõbʁ
nombreux	nõ.ˈbʁø
nombril	nõ.ˈbʁil
nommer	nɔ.ˈme
non	nõ
nord	nɔʁ
nordafricain	nɔʁ.da.fʁi.ˈkɛ̃
normal	nɔʁ.ˈmal
normand	nɔʁ.ˈmã
norvégien	nɔʁ.ve.ˈʒi
norvégienne	nɔʁ.veʒ.ˈjɛn
nostalgie	no.stal.ˈʒi
notaire	no.ˈtɛʁ
note	nɔt
noter	nɔ.ˈte
notion	nɔ.ˈtjõ
nouer	nue
nourrir	nu.ˈʁiʁ
nourriture	nu.ʁi.ˈtyʁ
nous	nu
nouveau	nu.ˈvo
nouvelle	nu.ˈvɛl
novembre	no.ˈvãbʁ
noyau	nwa.ˈjo
noyer	nwa.ˈje
nu	ny
nuage	nyaʒ
nuance	nyãs
nucléaire	ny.ˈkleɛʁ
nuire	nɥiʁ
nuisible	nɥi.ˈzibl
nuit	nɥi
nul	nyl
nulle part	nyl.ˈpaʁ
numéro	ny.me.ˈʁo
nuque	nyk
nurembergeois	ny.ʁã.bɛʁ.ˈʒwa
nylon	ni.ˈlõ
nymphe	nɛ̃f
nymphéa	nɛ̃.ˈfea
n'importe	nɛ̃.ˈpɔʁt
néanmoins	neã.ˈmwɛ̃
nécessaire	ne.se.ˈsɛʁ
nécessité	ne.se.si.ˈte
néerlandais	neɛʁ.lã.ˈdɛ
négligence	ne.gli.ˈʒãs
négligent	ne.ˈgliʒ
négliger	ne.gli.ˈʒe
négociant	ne.gɔ.ˈsjã
nématode	ne.ma.ˈtɔd
néon	neõ
népalais	ne.pa.ˈlɛ
névralgie faciale	ne.vʁal.ʒi.fa.ˈsjal
nègre	nɛgʁ
oasis	ɔa.ˈzis
objet	ob.ˈʒɛ
obligatoire	o.bli.ga.ˈtwaʁ
obliger	o.bli.ˈʒe
obliger à	o.bli.ˈʒea
oblique	o.ˈblik
obscur	ob.ˈskyʁ
obscurité	ob.sky.ʁi.ˈte
observation	ob.sɛʁ.va.ˈsjõ
observer	ob.sɛʁ.ˈve
obstacle	ob.ˈstakl
obstiné	ob.sti.ˈne
obséder	ɔb.se.ˈde
obsèques	ɔb.ˈsɛk
obtenir	ob.tə.ˈniʁ
obtus	ob.ˈty
obéir	o.ˈbeiʁ
obéissance	o.bei.ˈsãs
obéissant	o.bei.ˈsã
occasion	o.kaz.ˈjõ
occident	ok.ˈsid
occupation	o.ky.pa.ˈsjõ
occuper	o.ky.ˈpe
octet	ok.ˈtɛ
octobre	ok.ˈtɔbʁ
océan	ɔ.ˈseã
océan Antarctique	ɔ.seãã.taʁk.ˈtik
océan Arctique	ɔ.seãaʁk.ˈtik
océan Atlantique	ɔ.seãat.lã.ˈtik
océan Glacial du Nord	ɔ.seã.gla.sjal.dy.ˈnɔʁ
océan Pacifique	ɔ.seã.pa.si.ˈfik
odeur	o.ˈdœʁ
odeur délétère	o.dœʁ.de.le.ˈtɛʁ
odieux	o.ˈdjø
odorat	ɔ.dɔ.ˈʁa
offenser	o.fã.ˈse
office	o.ˈfis
office religieux	o.fis.ʁə.liʒ.ˈjø
officier	o.fi.ˈsje
offre	ɔfʁ
offrir	ɔ.ˈfʁiʁ
oficiel	o.fi.ˈsjɛl
oh	o
ohm	om
oie	wa
oignon	ɔ.ˈnjõ
oiseau	wa.ˈzo
oisillon	wa.zi.ˈjõ
olda	ɔl.ˈda
olive	ɔ.ˈliv
olivier	ɔ.li.ˈvje
ombre	õbʁ
omettre	o.ˈmɛtʁ
omnibus	ɔm.ni.ˈbys
omoplate	ɔ.mɔ.ˈplat
on	õ
oncle	õkl
ondatra	õ.da.ˈtʁa
onde	õd
ondoyer	õ.dwa.ˈje
onduler	õ.dy.ˈle
ongle	õgl
onze	õz
onzième	õz.ˈjɛm
opinion	o.pi.ˈnjõ
opportun	o.pɔʁ.ˈtœ̃
opposition	o.po.zi.ˈsjõ
opposé	o.po.ˈze
oppression	o.pʁɛ.ˈsjõ
opter	ɔp.ˈte
opticien	ɔp.ti.ˈsi
optimisme	ɔp.ti.ˈmism
opération	o.pe.ʁa.ˈsjõ
opération de caisse	o.pe.ʁa.sjõ.də.ˈkɛs
opérer	o.pe.ˈʁe
or	ɔʁ
orage	o.ˈʁaʒ
orange	o.ˈʁãʒ
oranger	o.ʁã.ˈʒe
orateur	o.ʁa.ˈtœʁ
orbite	oʁ.ˈbit
orchestration	ɔʁ.kɛ.stʁa.ˈsjõ
orchestre	ɔʁ.ˈkɛstʁ
orchestrer	ɔʁ.kɛ.ˈstʁe
ordinaire	oʁ.di.ˈnɛʁ
ordinairement	oʁ.di.nɛ.ˈʁəm
ordinateur	oʁ.di.na.ˈtœʁ
ordonnance	oʁ.do.ˈnãs
ordonner	oʁ.dɔ.ˈne
ordre	ɔʁdʁ
ordre du jour	ɔʁdʁ.dy.ˈʒuʁ
ordures	oʁ.ˈdyʁ
oreille	ɔ.ˈʁɛj
oreiller	ɔ.ʁɛ.ˈje
organe	oʁ.ˈgan
organiser	oʁ.ga.ni.ˈze
orge	ɔʁʒ
orgie	oʁ.ˈʒi
orgue	ɔʁg
orient	ɔ.ˈʁi
orifice	ɔ.ʁi.ˈfis
original	o.ʁi.ʒi.ˈnal
origine	o.ʁi.ˈʒin
orme	ɔʁm
ornament	ɔʁ.ˈnam
ornement	ɔʁ.ˈnəm
orner	ɔʁ.ˈne
orphelin	ɔʁ.fə.ˈlɛ̃
orteil	ɔʁ.ˈtɛj
orthodoxe	oʁ.to.ˈdɔks
orthographe	oʁ.to.ˈgʁaf
ortie	oʁ.ˈti
os	os
osciller	o.si.ˈje
oser	o.ˈze
oser attaquer	o.zea.ta.ˈke
oser entreprendre	o.zeã.tʁə.ˈpʁãdʁ
osseux	o.ˈsø
otage	o.ˈtaʒ
ou	u
ouate	wat
oublier	ubl.ˈje
ouest	wɛst
oui	wi
ouragan	u.ʁa.ˈgã
ours	uʁ
ourse	uʁs
outil	u.ˈti
outre	utʁ
ouverture	u.vɛʁ.ˈtyʁ
ouvrage	u.ˈvʁaʒ
ouvrier	uvʁ.ˈje
ouvrir	u.ˈvʁiʁ
ou bien	u.ˈbi
oxygène	ok.si.ˈʒɛn
ozone	o.ˈzɔn
oïl	oil
où	u
pacte	pakt
page	paʒ
paille	paj
pain	pɛ̃
paire	pɛʁ
paisible	pɛ.ˈzibl
paisiblement	pɛ.zi.ˈbləm
paix	pɛ
pakistanais	pa.ki.sta.ˈnɛ
palais	pa.ˈlɛ
paletot	pa.lə.ˈto
palladium	pa.la.ˈdjɔm
palmier	pal.ˈmje
palper	pal.ˈpe
pamplemousse	pã.plə.ˈmus
pan	pã
panaméen	pa.na.ˈme
panier	pa.ˈnje
panique	pa.ˈnik
panne	pan
panneau	pa.ˈno
panneau d'affichage	pa.no.da.fi.ˈʃaʒ
panorama	pa.no.ʁa.ˈma
panser	pã.ˈse
pantalon	pã.ta.ˈlõ
panthère	pã.ˈtɛʁ
pantoufle	pã.ˈtufl
paon	pã
papa	pa.ˈpa
paparazzo	pa.pa.ʁad.ˈzo
pape	pap
papier	pa.ˈpje
papier buvard	pa.pje.by.ˈvaʁ
papillon	pa.pi.ˈjõ
paprika	pa.pʁi.ˈka
paquet	pa.ˈkɛ
par	paʁ
parachute	pa.ʁa.ˈʃyt
parader	pa.ʁa.ˈde
paradis	pa.ʁa.ˈdi
paradoxe	pa.ʁa.ˈdɔks
parages	pa.ˈʁaʒ
parallèle	pa.ʁa.ˈlɛl
paralyser	pa.ʁa.li.ˈze
parapluie	pa.ʁapl.ˈɥi
paraître	pa.ˈʁɛtʁ
parc	paʁk
parce que	paʁ.ˈskə
parcourir	paʁ.ku.ˈʁiʁ
pardessus	paʁ.də.ˈsy
pardon	paʁ.ˈdõ
pardonner	paʁ.dɔ.ˈne
pareil	pa.ˈʁɛj
pareillement	pa.ʁɛ.ˈjəm
parent	paʁ
parente	pa.ˈʁãt
parenthèse	pa.ʁã.ˈtɛz
parents	paʁ
parer	pa.ˈʁe
parfait	paʁ.ˈfɛ
parfois	paʁ.ˈfwa
parfum	paʁ.ˈfym
parfumer	paʁ.fy.ˈme
parier	pa.ˈʁje
parlement	paʁ.ˈləm
parler	paʁ.ˈle
parler à	paʁ.ˈlea
parmi	paʁ.ˈmi
paroi	pa.ˈʁwa
paroisse	pa.ˈʁwas
parole	pa.ˈʁɔl
parrain	pa.ˈʁɛ̃
parsemer	paʁ.sə.ˈme
part	paʁ
partager	paʁ.ta.ˈʒe
parterre	paʁ.ˈtɛʁ
parti	paʁ.ˈti
participation aux bénéfices	paʁ.ti.si.pa.sjõo.be.ne.ˈfis
participe	paʁ.ti.ˈsip
participer	paʁ.ti.si.ˈpe
particulier	paʁ.ti.ky.ˈlje
particulièrement	paʁ.ti.ky.ljɛ.ˈʁəm
partie	paʁ.ˈti
partir	paʁ.ˈtiʁ
partisan	paʁ.ti.ˈzã
partisan de la même doctrine	paʁ.ti.zã.də.la.mɛm.dɔk.ˈtʁin
parti aux bénéfices	paʁ.tio.be.ne.ˈfis
partout	paʁ.ˈtu
parure	pa.ˈʁyʁ
parvenir	paʁ.və.ˈniʁ
par acclamation	pa.ʁa.kla.ma.ˈsjõ
par alliance	pa.ʁa.ˈljãs
par exemple	pa.ʁɛg.ˈzãpl
par hasard	pa.ʁa.ˈzaʁ
par moins	paʁ.ˈmwɛ̃
par voie d'adjudication	paʁ.vwa.dad.ʒy.di.ka.ˈsjõ
pas	pa
passablement	pa.sa.ˈbləm
passager	pa.sa.ˈʒe
passeport	pa.sə.ˈpɔʁ
passer	pa.ˈse
passereau	pa.sə.ˈʁo
passer chez	pa.se.ˈʃe
passer la nuit	pa.se.la.ˈnɥi
passer à tabac	pa.sea.ta.ˈba
passion	pa.ˈsjõ
passionnant	pa.sjɔ.ˈnã
passé	pa.ˈse
pasteur	pa.ˈstœʁ
pas du tout	pa.dy.ˈtu
patauger	pa.to.ˈʒe
patience	pa.ˈsjãs
patient	pa.ˈti
patin	pa.ˈtɛ̃
patriote	pa.ˈtʁiɔt
patron	pa.ˈtʁõ
patte	pat
paume	pom
paupière	po.ˈpjɛʁ
pause	poz
pauvre	povʁ
pavillon	pa.vi.ˈjõ
pavot	pa.ˈvo
pavé	pa.ˈve
paye	pɛj
payer	pɛ.ˈje
payer un premier acompte	pɛ.jeœ̃.pʁə.mjea.ˈkõt
pays	pɛj
paysage	pei.ˈzaʒ
paysan	pei.ˈzã
pays de Galles	pɛj.də.ˈgal
peau	po
peau de vache	po.də.ˈvaʃ
peigne	pɛnj
peigner	pɛ.ˈnje
peindre	pɛ̃dʁ
peine	pɛn
peiner	pɛ.ˈne
peintre	pɛ̃tʁ
peinture	pɛ̃.ˈtyʁ
peiné	pɛ.ˈne
pelage	pə.ˈlaʒ
pelle	pɛl
pelleter	pɛ.lə.ˈte
pellicule	pɛ.li.ˈkyl
pelouse	pə.ˈluz
pencher	pã.ˈʃe
pendant	pã.ˈdã
pendant que	pã.dã.ˈkə
pendre	pãdʁ
pendule	pã.ˈdyl
penible	pə.ˈnibl
penser	pã.ˈse
penser que	pã.se.ˈkə
pension	pã.ˈsjõ
pensionnat	pã.sjɔ.ˈna
pension alimentaire	pã.sjõa.li.mã.ˈtɛʁ
pension de famille	pã.sjõ.də.fa.ˈmij
pensée	pã.ˈse
pente	pãt
percer	pɛʁ.ˈse
percevoir	pɛʁ.sə.ˈvwaʁ
perche	pɛʁʃ
perdre	pɛʁdʁ
perdrix	pɛʁ.ˈdʁi
perfection	pɛʁ.fɛk.ˈsjõ
perfide	pɛʁ.ˈfid
peril	pə.ˈʁil
perle	pɛʁl
perluète	pɛʁ.ˈlyɛt
permanent	pɛʁ.ˈman
permettre	pɛʁ.ˈmɛtʁ
permis	pɛʁ.ˈmi
permission	pɛʁ.mi.ˈsjõ
perpétuel	pɛʁ.pɛ.ˈtyɛl
perroquet	pɛ.ʁɔ.ˈkɛ
perruque	pɛ.ˈʁyk
persan	pɛʁ.ˈsã
persil	pɛʁ.ˈsi
persister	pɛʁ.si.ˈste
personnage	pɛʁ.so.ˈnaʒ
personne	pɛʁ.ˈsɔn
personnel	pɛʁ.so.ˈnɛl
personne qui ne boit jamais d'alcool	pɛʁ.sɔn.ki.nə.bwa.ʒa.mɛ.dal.ˈkɔl
person de connaissance	pɛʁ.sõ.də.ko.nɛ.ˈsãs
perspective	pɛʁ.spɛk.ˈtiv
persuader	pɛʁ.sya.ˈde
perséverer	pɛʁ.se.və.ˈʁe
persévérer	pɛʁ.se.ve.ˈʁe
perte	pɛʁt
pertinence	pɛʁ.ti.ˈnãs
perturber	pɛʁ.tyʁ.ˈbe
pervenche	pɛʁ.ˈvãʃ
perçant	pɛʁ.ˈsã
pesanteur	pə.zã.ˈtœʁ
peser	pə.ˈze
pessimisme	pɛ.si.ˈmism
pessimiste	pɛ.si.ˈmist
pestilentiel	pɛ.sti.lã.ˈsjɛl
pet	pɛ
petit	pə.ˈti
petit déjeuner	pə.ti.de.ʒœ.ˈne
petit pain	pə.ti.ˈpɛ̃
petit à petit	pə.tia.pə.ˈti
peuple	pœpl
peuplier	pœpl.ˈje
peur	pœʁ
peureux	pœ.ˈʁø
peu de	pø.ˈdə
peu à peu	pøa.ˈpø
phare	faʁ
pharmacie	faʁ.ma.ˈsi
pharmacien	faʁ.ma.ˈsi
phase	faz
philippin	fi.li.ˈpɛ̃
philosophie	fi.lo.zo.ˈfi
phonographe	fo.no.ˈgʁaf
phoque	fɔk
phosphore	fo.ˈsfɔʁ
photo	fo.ˈto
photographe	fo.to.ˈgʁaf
photographie	fo.to.gʁa.ˈfi
photographier	fo.to.gʁa.ˈfje
phrase	fʁaz
physique	fi.ˈzik
phénix	fe.ˈni
phénomène	fe.nɔ.ˈmɛn
piano	pja.ˈno
pie	pi
pierre	pjɛʁ
pieu	pjø
pieuvre	pjœvʁ
pieux	pjø
pigeon	pi.ˈʒõ
piler	pi.ˈle
pilier	pi.ˈlje
piller	pi.ˈje
piloter	pi.lɔ.ˈte
pilote de ligne	pi.lɔt.də.ˈlinj
pilule	pi.ˈlyl
pin	pɛ̃
pinceau	pɛ̃.ˈso
pincer	pɛ̃.ˈse
pinces	pɛ̃s
pioche	pjɔʃ
pionnier	pjɔ.ˈnje
pipe	pip
piquant	pi.ˈkã
piquer	pi.ˈke
piqûre	pi.ˈkyʁ
pirate de l'air	pi.ʁat.də.ˈlɛʁ
pire	piʁ
pis	pi
piscine	pi.ˈsin
pissenlit	pi.sã.ˈli
pisser	pi.ˈse
piste	pist
pistil	pi.ˈstil
pistolet	pi.stɔ.ˈlɛ
piston	pi.ˈstõ
pitié	pi.ˈtje
pittoresque	pi.to.ˈʁɛsk
pivot	pi.ˈvo
piétiner	pje.ti.ˈne
piéton	pje.ˈtõ
pièce	pjɛs
pièce de théâtre	pjɛs.də.ˈteatʁ
piège	pjɛʒ
placard	pla.ˈkaʁ
place	plas
placer	pla.ˈse
placer d'argent	pla.se.ˈdaʁʒ
plafond	pla.ˈfõ
plage	plaʒ
plaider	plɛ.ˈde
plaie	plɛ
plaindre	plɛ̃dʁ
plaine	plɛn
plainte	plɛ̃t
plaire	plɛʁ
plaisir	plɛ.ˈziʁ
plan	plã
planche	plãʃ
plancher	plã.ˈʃe
planer	pla.ˈne
plante	plãt
planter	plã.ˈte
plante du pied	plãt.dy.ˈpje
planète	pla.ˈnɛt
plaque	plak
plastique	pla.ˈstik
plat	pla
platane	pla.ˈtan
plateau	pla.ˈto
platine	pla.ˈtin
pleur	plœʁ
pleurer	plœ.ˈʁe
pleuvoir	plœ.ˈvwaʁ
pli	pli
plier	plje
plomb	plõ
plonger	plõ.ˈʒe
plongé dans	plõ.ʒe.ˈdã
ployer	plwa.ˈje
pluie	plɥi
plume	plym
plupart	ply.ˈpaʁ
plus	ply
plusieurs	plyz.ˈjœʁ
plusieurs fois	plyz.jœʁ.ˈfwa
plus loin	ply.ˈlwɛ̃
plutonium	ply.to.ˈnjɔm
plutôt	ply.ˈto
poche	pɔʃ
poids	pwa
poids lourd	pwa.ˈluʁ
poignet	pwa.ˈnjɛ
poignée	pwa.ˈnje
poignée de main	pwa.nje.də.ˈmɛ̃
poil	pwal
poilu	pwa.ˈly
poil d'animal	pwal.da.ni.ˈmal
poing	pwɛ̃
point	pwɛ̃
pointe	pwɛ̃t
pointu	pwɛ̃.ˈty
point culminant	pwɛ̃.kyl.mi.ˈnã
point de contact	pwɛ̃.də.kõ.ˈtakt
point de vue	pwɛ̃.də.ˈvy
point du jour	pwɛ̃.dy.ˈʒuʁ
poire	pwaʁ
poirier	pwa.ˈʁje
pois	pwa
poison	pwa.ˈzõ
poisson	pwa.ˈsõ
poitrine	pwa.ˈtʁin
poivre	pwavʁ
poli	pɔ.ˈli
police	pɔ.ˈlis
policier	pɔ.li.ˈsje
polir	pɔ.ˈliʁ
politesse	pɔ.li.ˈtɛs
politique	pɔ.li.ˈtik
pollution atmosphérique	pɔ.ly.tjõat.mɔ.sfe.ˈʁik
polonais	pɔ.lo.ˈnɛ
polynésien	pɔ.li.ne.ˈzi
polémique	pɔ.le.ˈmik
pomme	pɔm
pomme de pin	pɔm.də.ˈpɛ̃
pomme de terre	pɔm.də.ˈtɛʁ
pommier	pɔ.ˈmje
pompe	põp
pomper	põ.ˈpe
pompette	põ.ˈpɛt
ponctuation	põk.tya.ˈsjõ
ponctuel	põk.ˈtyɛl
pont	põ
pont aérien	põae.ˈʁi
populaire	po.py.ˈlɛʁ
population	po.py.la.ˈsjõ
porc	pɔʁ
port	pɔʁ
porte	pɔʁt
portefeuille d'actions	pɔʁ.tə.fœj.dak.ˈsjõ
porter	pɔʁ.ˈte
porter plainte	pɔʁ.te.ˈplɛ̃t
porteur	pɔʁ.ˈtœʁ
porte document	pɔʁt.do.ˈkym
portion	pɔʁ.ˈtjõ
portrait	poʁ.ˈtʁɛ
portugais	pɔʁ.ty.ˈgɛ
poser	po.ˈze
poser une question	po.zeyn.kɛst.ˈjõ
poseur	po.ˈzœʁ
positif	po.zi.ˈtif
position	po.zi.ˈsjõ
possession	po.sɛ.ˈsjõ
possible	po.ˈsibl
posséder	po.se.ˈde
poste	pɔst
poste aérienne	pɔ.stae.ˈʁjɛn
pot	po
potable	po.ˈtabl
potage	po.ˈtaʒ
potassium	po.ta.ˈsjɔm
poteau	po.ˈto
potiron	pɔ.ti.ˈʁõ
pou	pu
pouah	pwa
poubelle	pu.ˈbɛl
pouce	pus
poudre	pudʁ
poudre à canon	pu.dʁa.ka.ˈnõ
poulailler	pu.la.ˈje
poule	pul
poulet	pu.ˈlɛ
poulpe	pulp
pouls	pul
poumon	pu.ˈmõ
poupée	pu.ˈpe
pour	puʁ
pourboire	puʁ.ˈbwaʁ
pourcentage	puʁ.sã.ˈtaʒ
pourchasser	puʁ.ʃa.ˈse
pourpre	puʁpʁ
pourrir	pu.ˈʁiʁ
poursuivre	puʁ.ˈsɥivʁ
pourtant	puʁ.ˈtã
pourvoir	puʁ.ˈvwaʁ
pour ainsi dire	pu.ʁɛ̃.si.ˈdiʁ
pour combien de temps	puʁ.kõ.bi.də.ˈtã
pour la plus part	puʁ.la.ply.ˈpaʁ
pour que	puʁ.ˈkə
pour toutes sortes de raisons	puʁ.tut.sɔʁt.də.ʁɛ.ˈzõ
pousser	pu.ˈse
pousser à	pu.ˈsea
poussin	pu.ˈsɛ̃
poussière	pu.ˈsjɛʁ
poutre	putʁ
pouvoir	pu.ˈvwaʁ
poésie	pɔe.ˈzi
poème	poɛm
poète	poɛt
poêle	pwal
prairie	pʁɛ.ˈʁi
pratique	pʁa.ˈtik
pratiquer	pʁa.ti.ˈke
premier	pʁə.ˈmje
premier acompte	pʁə.mjea.ˈkõt
prendre	pʁãdʁ
prendre dans les bras	pʁãdʁ.dã.le.ˈbʁa
prendre fin	pʁãdʁ.ˈfɛ̃
prendre l'initiative	pʁãdʁ.li.ni.sja.ˈtiv
prendre part	pʁãdʁ.ˈpaʁ
prendre à bail	pʁã.dʁa.ˈbaj
presque	pʁɛsk
presqu'île	pʁɛ.ˈskil
presse	pʁɛs
presser	pʁɛ.ˈse
presser le pas	pʁɛ.se.lə.ˈpa
pression	pʁɛ.ˈsjõ
pression atmosphérique	pʁɛ.sjõat.mɔ.sfe.ˈʁik
prestige	pʁɛ.ˈstiʒ
preuve	pʁœv
prier	pʁie
primaire	pʁi.ˈmɛʁ
primeur	pʁi.ˈmœʁ
primevère	pʁi.mə.ˈvɛʁ
prince	pʁɛ̃s
princesse	pʁɛ̃.ˈsɛs
principal	pʁɛ̃.si.ˈpal
principalement	pʁɛ̃.si.pa.ˈləm
principe	pʁɛ̃.ˈsip
printemps	pʁɛ̃.ˈtã
prise	pʁiz
prise de courant	pʁiz.də.ku.ˈʁã
prise de courant femelle	pʁiz.də.ku.ʁã.fə.ˈmɛl
prise de courant mâle	pʁiz.də.ku.ʁã.ˈmal
prison	pʁi.ˈzõ
prisonnier	pʁi.zɔ.ˈnje
privation	pʁi.va.ˈsjõ
privilégié	pʁi.vi.leʒ.ˈje
privilège	pʁi.vi.ˈlɛʒ
privé	pʁi.ˈve
prix	pʁi
prière	pʁiɛʁ
probablement	pʁo.ba.ˈbləm
problème	pʁo.ˈblɛm
procession	pʁo.sɛ.ˈsjõ
processus	pʁɔ.se.ˈsy
prochain	pʁo.ˈʃɛ̃
prochaine	pʁo.ˈʃɛn
proche	pʁɔʃ
proches	pʁɔʃ
proclamer	pʁo.kla.ˈme
procurer	pʁo.ky.ˈʁe
procureur	pʁo.ky.ˈʁœʁ
procéder	pʁo.se.ˈde
procédé	pʁo.se.ˈde
procès	pʁo.ˈsɛ
prodigieux	pʁo.diʒ.ˈjø
prodiguer	pʁo.di.ˈge
production	pʁo.dyk.ˈsjõ
produire	pʁo.ˈdɥiʁ
produit	pʁo.ˈdɥi
produit agricole	pʁo.dɥia.gʁi.ˈkɔl
professeur	pʁo.fɛ.ˈsœʁ
profession	pʁo.fɛ.ˈsjõ
profit	pʁo.ˈfi
profiter	pʁo.fi.ˈte
profond	pʁo.ˈfõ
profondeur	pʁo.fõ.ˈdœʁ
prognostic	pʁo.njo.ˈstik
progresser	pʁɔ.gʁe.ˈse
progrès	pʁo.ˈgʁɛ
proie	pʁwa
projectile	pʁo.ʒɛk.ˈtil
projet	pʁo.ˈʒɛ
projeter	pʁo.ʒə.ˈte
projeter une image	pʁo.ʒə.tey.ni.ˈmaʒ
projeter un liquide	pʁo.ʒə.teœ̃.li.ˈkid
prologue	pʁɔ.ˈlɔg
prolonger	pʁɔ.lõ.ˈʒe
prolétaire	pʁɔ.le.ˈtɛʁ
promenade	pʁo.mə.ˈnad
promeneur	pʁo.mə.ˈnœʁ
promesse	pʁo.ˈmɛs
promettre	pʁo.ˈmɛtʁ
promoteur	pʁɔ.mɔ.ˈtœʁ
promotion	pʁɔ.mɔ.ˈtjõ
promouvoir	pʁɔ.mu.ˈvwaʁ
prompt	pʁõpt
prononcer	pʁo.nõ.ˈse
prononciation	pʁo.nõ.sja.ˈsjõ
propagande	pʁo.pa.ˈgãd
propager	pʁo.pa.ˈʒe
prophète	pʁo.ˈfɛt
propice	pʁo.ˈpis
proportion	pʁɔ.pɔʁ.ˈtjõ
propos	pʁo.ˈpo
proposition	pʁo.po.zi.ˈsjõ
propre	pʁɔpʁ
proprement	pʁo.ˈpʁəm
propreté	pʁo.pʁə.ˈte
propriété	pʁo.pʁje.ˈte
propriété foncière	pʁo.pʁje.te.fõ.ˈsjɛʁ
prospectus	pʁo.spɛk.ˈtys
prospérer	pʁo.spe.ˈʁe
prospérité	pʁo.spe.ʁi.ˈte
prostituer	pʁo.sti.ˈtye
prostitution	pʁo.sti.ty.ˈtjõ
prostituée	pʁo.sti.ˈtye
protecteur	pʁo.tɛk.ˈtœʁ
protection	pʁo.tɛk.ˈsjõ
protestant	pʁo.tɛ.ˈstã
protestation	pʁo.tɛ.sta.ˈsjõ
protester	pʁo.tɛ.ˈste
protocole	pʁo.to.ˈkɔl
proton	pʁo.ˈtõ
prototype	pʁo.to.ˈtip
protéger	pʁo.te.ˈʒe
protéine	pʁo.ˈtein
prouver	pʁu.ˈve
provenir	pʁo.və.ˈniʁ
proverbe	pʁo.ˈvɛʁb
province	pʁo.ˈvɛ̃s
provision	pʁo.viz.ˈjõ
provisoire	pʁo.viz.ˈwaʁ
provoquer	pʁo.vɔ.ˈke
prudence	pʁy.ˈdãs
prudent	pʁyd
prune	pʁyn
prussien	pʁy.ˈsi
pré	pʁe
précaution	pʁe.ko.ˈtjõ
précieux	pʁe.ˈsjø
précipitation	pʁe.si.pi.ta.ˈsjõ
précipiter	pʁe.si.pi.ˈte
précis	pʁe.ˈsi
précisément	pʁe.si.ˈzem
précoce	pʁe.ˈkɔs
précédent	pʁe.ˈsed
précéder	pʁe.se.ˈde
prédire	pʁe.ˈdiʁ
préface	pʁe.ˈfas
préfixe	pʁe.ˈfiks
préférer	pʁe.fe.ˈʁe
préjudice	pʁe.ʒy.ˈdis
préjugé	pʁe.ʒy.ˈʒe
prélever	pʁe.lə.ˈve
prématuré	pʁe.ma.ty.ˈʁe
prénom	pʁe.ˈnõ
préoccuper	pʁeɔ.ky.ˈpe
préparatif	pʁe.pa.ʁa.ˈtif
préparation	pʁe.pa.ʁa.ˈsjõ
préparer	pʁe.pa.ˈʁe
préposition	pʁe.po.zi.ˈsjõ
présence	pʁe.ˈzãs
présent	pʁez
présentation	pʁe.zã.ta.ˈsjõ
présenter	pʁe.zã.ˈte
préservatif	pʁe.zɛʁ.va.ˈtif
préserver	pʁe.zɛʁ.ˈve
président	pʁe.ˈzid
présider	pʁe.zi.ˈde
prétendre à	pʁe.tã.ˈdʁa
prétexte	pʁe.ˈtɛkst
prétexter	pʁe.tɛk.ˈste
prévenir	pʁɛv.ˈniʁ
prévisible	pʁe.vi.ˈzibl
prévoir	pʁe.ˈvwaʁ
près	pʁɛ
près de	pʁɛ.ˈdə
prêcher	pʁɛ.ˈʃe
prêt	pʁɛ
prêter	pʁɛ.ˈte
prêter attention à	pʁɛ.tea.tã.ˈtjõa
prêter serment	pʁɛ.te.ˈsɛʁm
prêtre	pʁɛtʁ
psaume	psom
pseudonyme	psø.dɔ.ˈnim
psychiatre	psi.ˈkjatʁ
psychiatrie	psi.kja.ˈtʁi
psychique	psi.ˈʃik
psychisme	psi.ˈʃism
psychologie	psi.ko.lo.ˈʒi
psychologue	psi.ko.ˈlɔg
public	py.ˈblik
publicité	py.bli.si.ˈte
publier	pybl.ˈje
puce	pys
puis	pɥi
puiser	pɥi.ˈze
puisque	pɥisk
puissance	pɥi.ˈsãs
puissant	pɥi.ˈsã
puits	pɥi
puits de mine	pɥi.də.ˈmin
puma	py.ˈma
punaise	py.ˈnɛz
punir	py.ˈniʁ
punition	py.ni.ˈsjõ
pupitre	py.ˈpitʁ
pur	pyʁ
purifier	py.ʁi.ˈfje
purin	py.ˈʁɛ̃
purée	py.ˈʁe
pus	py
putain	py.ˈtɛ̃
puzzle	pyzzl
pygmée	pig.ˈme
pyjama	pi.ʒa.ˈma
pyramide	pi.ʁa.ˈmid
pécher	pe.ˈʃe
péché	pe.ˈʃe
pédale	pe.ˈdal
pédale d'accélération	pe.dal.dak.se.le.ʁa.ˈsjõ
pélargonium	pe.laʁ.go.ˈnjɔm
pélican	pe.li.ˈkã
pénible	pe.ˈnibl
péniblement	pe.ni.ˈbləm
péniche	pe.ˈniʃ
péninsule	pe.nɛ̃.ˈsyl
pénis	pe.ˈni
pénétrer	pe.ne.ˈtʁe
pépier	pe.ˈpje
pépin	pe.ˈpɛ̃
périlleux	pe.ʁi.ˈjø
période	pe.ˈʁjɔd
périr	pe.ˈʁiʁ
pérégriner	pe.ʁe.gʁi.ˈne
pétale	pe.ˈtal
péter	pe.ˈte
pétrir	pe.ˈtʁiʁ
pétrole	pe.ˈtʁɔl
père	pɛʁ
père adoptif	pɛ.ʁa.dɔp.ˈtif
père et mère	pɛ.ʁe.ˈmɛʁ
pâle	pal
pâlir	pa.ˈliʁ
pâquerette	pa.kə.ˈʁɛt
pâte	pat
pâtisserie	pa.ti.sə.ˈʁi
pâtre	patʁ
pâturage	pa.ty.ˈʁaʒ
pâture	pa.ˈtyʁ
pâté	pa.ˈte
pêche	pɛʃ
pêcher	pɛ.ˈʃe
pêcheur	pɛ.ˈʃœʁ
pêcheur à la ligne	pɛ.ʃœ.ʁa.la.ˈlinj
pôle	pol
quai	kɛ
qualifier	ka.li.ˈfje
qualifié	ka.li.ˈfje
qualité	ka.li.ˈte
quand	kã
quantité	kã.ti.ˈte
quant à	kãa
quant à moi	kãa.ˈmwa
quarante	ka.ˈʁãt
quart	kaʁ
quartier	kaʁ.ˈtje
quartz	kaʁts
quatorze	ka.ˈtɔʁz
quatorzième	ka.tɔʁz.ˈjɛm
quatre	katʁ
quatrième	ka.ˈtʁiɛm
que	kə
quel	kɛl
quelconque	kɛl.ˈkõk
quelle	kɛl
quelles	kɛl
quelle heure	kɛ.ˈlœʁ
quelquefois	kɛl.kə.ˈfwa
quelques	kɛlk
quelques uns	kɛl.ˈkœ̃
quelque chose	kɛlk.ˈʃoz
quelque part	kɛlk.ˈpaʁ
quelqu'un	kɛl.ˈky
quels	kɛl
querelle	kə.ˈʁɛl
question	kɛst.ˈjõ
queue	kø
qui	ki
quiet	kjɛ
quinze	kɛ̃z
quittance	ki.ˈtãs
quitter	ki.ˈte
qui a raison	kia.ʁɛ.ˈzõ
qui reste	ki.ˈʁɛst
quoi	kwa
quoique	kwak
quotidien	ko.ti.ˈdi
quotidiennement	ko.ti.djɛ.ˈnəm
qu'	k
rabais	ʁa.ˈbɛ
rabbin	ʁa.ˈbɛ̃
rabot	ʁa.ˈbo
raccommoder	ʁa.ko.mɔ.ˈde
raccourcir	ʁa.kuʁ.ˈsiʁ
race	ʁas
racine	ʁa.ˈsin
raconter	ʁa.kõ.ˈte
radeau	ʁa.ˈdo
radiateur	ʁa.dja.ˈtœʁ
radical	ʁa.di.ˈkal
radio	ʁa.ˈdjo
radis	ʁa.ˈdi
radium	ʁa.ˈdjɔm
radon	ʁa.ˈdõ
raffiner	ʁa.fi.ˈne
rafraîchir	ʁa.fʁɛ.ˈʃiʁ
rage	ʁaʒ
ragoût	ʁa.ˈgu
raide	ʁɛd
raidir	ʁɛ.ˈdiʁ
raie	ʁɛ
raifort	ʁɛ.ˈfɔʁ
rail	ʁaj
railler	ʁa.ˈje
rainure	ʁɛ.ˈnyʁ
raisin	ʁɛ.ˈzɛ̃
raison	ʁɛ.ˈzõ
raisonable	ʁɛ.zo.ˈnabl
raisonnable	ʁɛ.zo.ˈnabl
ralentir	ʁa.lã.ˈtiʁ
ramasser	ʁa.ma.ˈse
rame	ʁam
rameau	ʁa.ˈmo
ramer	ʁa.ˈme
rammasser	ʁa.ma.ˈse
rampe	ʁãp
ramper	ʁã.ˈpe
rancune	ʁã.ˈkyn
rand	ʁã
randonnée	ʁã.dɔ.ˈne
rang	ʁãg
ranger	ʁã.ˈʒe
rangée	ʁã.ˈʒe
rapide	ʁa.ˈpid
rapidement	ʁa.pi.ˈdəm
rapides Deschênes	ʁa.pid.dɛ.ˈʃɛn
rapides Norman	ʁa.pid.nɔʁ.ˈman
rapides Remic	ʁa.pi.dʁə.ˈmik
rapidité	ʁa.pi.di.ˈte
rapiécer	ʁa.pje.ˈse
rappeler	ʁa.pə.ˈle
rapper	ʁa.ˈpe
rapport	ʁa.ˈpɔʁ
rapporter	ʁa.pɔʁ.ˈte
rapporter des propos	ʁa.pɔʁ.te.de.pʁo.ˈpo
rapprocher	ʁa.pʁɔ.ˈʃe
rapsodie	ʁa.psɔ.ˈdi
rare	ʁaʁ
rarement	ʁa.ˈʁəm
raser	ʁa.ˈze
rassasié	ʁa.saz.ˈje
rassembler	ʁa.sã.ˈble
rassis	ʁa.ˈsi
rassurer	ʁa.sy.ˈʁe
rat	ʁa
rater	ʁa.ˈte
ration	ʁa.ˈsjõ
rationnel	ʁa.sjo.ˈnɛl
raton laveur	ʁa.tõ.la.ˈvœʁ
rattraper	ʁa.tʁa.ˈpe
rat musqué	ʁa.my.ˈske
rauque	ʁok
ravage	ʁa.ˈvaʒ
ravager	ʁa.va.ˈʒe
ravin	ʁa.ˈvɛ̃
ravir	ʁa.ˈviʁ
ravissant	ʁa.vi.ˈsã
ravisseur	ʁa.vi.ˈsœʁ
ravitaillement	ʁa.vi.ta.ˈjəm
rayer	ʁɛ.ˈje
rayon	ʁɛ.ˈjõ
rayonner	ʁɛ.jɔ.ˈne
rayon de rangement	ʁɛ.jõ.də.ʁã.ˈʒəm
rayon de soleil	ʁɛ.jõ.də.sɔ.ˈlɛj
rayure	ʁɛ.ˈjyʁ
rebelle	ʁə.ˈbɛl
rebondir	ʁə.bõ.ˈdiʁ
recensement	ʁə.sã.ˈsəm
receptionniste	ʁə.sɛps.jo.ˈnist
recette	ʁə.ˈsɛt
recevabilité	ʁə.sə.va.bi.li.ˈte
recevoir	ʁə.sə.ˈvwaʁ
recevoir des visiteurs	ʁə.sə.vwaʁ.de.vi.zi.ˈtœʁ
recevoir officiellement	ʁə.sə.vwa.ʁo.fi.sjɛ.ˈləm
recevoir solennellement	ʁə.sə.vwaʁ.sɔ.lã.nɛ.ˈləm
recherche	ʁə.ˈʃɛʁʃ
rechercher	ʁə.ʃɛʁ.ˈʃe
recommandable	ʁə.ko.mã.ˈdabl
recommandation	ʁə.ko.mã.da.ˈsjõ
recommander	ʁə.ko.mã.ˈde
recommandé	ʁə.ko.mã.ˈde
recommencer	ʁə.ko.mã.ˈse
reconduire	ʁə.kõ.ˈdɥiʁ
reconnaissance	ʁə.ko.nɛ.ˈsãs
reconnaissant	ʁə.ko.nɛ.ˈsã
reconnaître	ʁə.kɔ.ˈnɛtʁ
record	ʁə.ˈkɔʁ
recourir à	ʁə.ku.ʁi.ˈʁa
recours	ʁə.ˈkuʁ
recouvrer	ʁə.ku.ˈvʁe
recouvrir	ʁə.ku.ˈvʁiʁ
recruter	ʁə.kʁy.ˈte
rectangle	ʁɛk.ˈtãgl
rectifier	ʁɛk.ti.ˈfje
recueiller	ʁə.kœ.ˈje
recueillir	ʁə.kœ.ˈjiʁ
reculer	ʁə.ky.ˈle
redire	ʁə.ˈdiʁ
redoubler	ʁə.du.ˈble
redoutable	ʁə.du.ˈtabl
redouter	ʁə.du.ˈte
redresser	ʁə.dʁɛ.ˈse
redresser un jugement	ʁə.dʁɛ.seœ̃.ʒy.ˈʒəm
refaire	ʁə.ˈfɛʁ
reflet	ʁə.ˈflɛ
refléter	ʁə.flɛ.ˈte
reformer	ʁə.fɔʁ.ˈme
refuge	ʁə.ˈfyʒ
refuser	ʁə.fy.ˈze
regagner	ʁə.ga.ˈnje
regard	ʁə.ˈgaʁ
regarder	ʁə.gaʁ.ˈde
regarder bouche bée	ʁə.gaʁ.de.buʃ.ˈbe
regarder un spectacle	ʁə.gaʁ.deœ̃.spɛk.ˈtakl
regret	ʁə.ˈgʁɛ
regretter	ʁə.gʁɛ.ˈte
rein	ʁɛ̃
reine	ʁɛn
reins	ʁɛ̃
rejeter	ʁə.ʒə.ˈte
rejeter de la nourriture	ʁə.ʒə.te.də.la.nu.ʁi.ˈtyʁ
rejeter par intolérance	ʁə.ʒə.te.pa.ʁɛ̃.tɔ.le.ˈʁãs
rejoindre	ʁə.ˈʒwɛ̃dʁ
relatif	ʁə.la.ˈtif
relatif à la maison	ʁə.la.ti.fa.la.mɛ.ˈzõ
relation	ʁə.la.ˈsjõ
relativement	ʁə.la.ˈtivm
relier	ʁə.ˈlje
religieux	ʁə.liʒ.ˈjø
religion	ʁə.liʒ.ˈjõ
reliquat	ʁə.li.ˈka
relire	ʁə.ˈliʁ
rellier	ʁɛ.ˈlje
relâcher	ʁə.la.ˈʃe
remarquable	ʁə.maʁ.ˈkabl
remarque	ʁə.ˈmaʁk
rembourrer	ʁã.bu.ˈʁe
rembourser	ʁã.buʁ.ˈse
remerciement	ʁə.mɛʁ.ˈsim
remercier	ʁə.mɛʁ.ˈsje
remise	ʁə.ˈmiz
remonter	ʁə.mõ.ˈte
remorque	ʁə.ˈmɔʁk
remplacer	ʁã.pla.ˈse
remplir	ʁã.ˈpliʁ
remporter	ʁã.pɔʁ.ˈte
remuer	ʁə.ˈmye
remédier	ʁə.me.ˈdje
remède	ʁə.ˈmɛd
renard	ʁə.ˈnaʁ
renarde	ʁə.ˈnaʁd
rencontre	ʁã.ˈkõtʁ
rencontrer	ʁã.kõ.ˈtʁe
rendre	ʁãdʁ
rendre confus	ʁãdʁ.kõ.ˈfy
rendre plus beau	ʁãdʁ.ply.ˈbo
rendre trouble	ʁãdʁ.ˈtʁubl
renfermer	ʁã.fɛʁ.ˈme
rennomée	ʁã.nɔ.ˈme
renommée	ʁə.nɔ.ˈme
renoncer	ʁə.nõ.ˈse
renouveler	ʁə.nu.və.ˈle
renseignement	ʁã.sɛ.ˈnjəm
renseigner	ʁã.sɛ.ˈnje
rente	ʁãt
rentrée	ʁã.ˈtʁe
renverser	ʁã.vɛʁ.ˈse
renvoyer	ʁã.vwa.ˈje
repas	ʁə.ˈpa
repasser	ʁə.pa.ˈse
reporter	ʁə.pɔʁ.ˈte
repos	ʁə.ˈpo
repoussant	ʁə.pu.ˈsã
repousser	ʁə.pu.ˈse
reprendre	ʁə.ˈpʁãdʁ
reprise	ʁə.ˈpʁiz
reproche	ʁə.ˈpʁɔʃ
reprocher	ʁə.pʁɔ.ˈʃe
représentant	ʁə.pʁe.zã.ˈtã
représentatif	ʁə.pʁe.zã.ta.ˈtif
représentation	ʁə.pʁe.zã.ta.ˈsjõ
représenter	ʁə.pʁe.zã.ˈte
requin	ʁə.ˈkɛ̃
requérir	ʁə.ke.ˈʁiʁ
requête	ʁə.ˈkɛt
respect	ʁɛ.ˈspɛ
respecter	ʁɛ.spɛk.ˈte
respectif	ʁɛ.spɛk.ˈtif
respiration	ʁɛ.spi.ʁa.ˈsjõ
respirer	ʁɛ.spi.ˈʁe
respondre	ʁɛ.ˈspõdʁ
responsable	ʁɛ.spõ.ˈsabl
ressembler	ʁə.sã.ˈble
ressentir	ʁə.sã.ˈtiʁ
ressort	ʁə.ˈsɔʁ
ressource	ʁə.ˈsuʁs
restaurant	ʁɛ.stɔ.ˈʁã
restaurer	ʁɛ.stɔ.ˈʁe
reste	ʁɛst
rester	ʁɛ.ˈste
rester en arrière	ʁɛ.stea.ˈʁjɛʁ
retarder	ʁə.taʁ.ˈde
retenir	ʁə.tə.ˈniʁ
retirer	ʁə.ti.ˈʁe
retomber	ʁə.tõ.ˈbe
retour	ʁə.ˈtuʁ
retourner	ʁə.tuʁ.ˈne
retraite	ʁə.ˈtʁɛt
retraité	ʁə.tʁɛ.ˈte
retrancher	ʁə.tʁã.ˈʃe
revanche	ʁə.ˈvãʃ
revenir	ʁə.və.ˈniʁ
revenir toujours sur la même chapitre	ʁə.və.niʁ.tu.ʒuʁ.syʁ.la.mɛm.ʃa.ˈpitʁ
revenir à	ʁə.və.ni.ˈʁa
revenu	ʁə.və.ˈny
revoir	ʁə.ˈvwaʁ
revolver	ʁə.vɔl.ˈve
revue	ʁə.ˈvy
revêtir	ʁə.vɛ.ˈtiʁ
reçu	ʁə.ˈsy
re retirer	ʁə.ʁə.ti.ˈʁe
rhinocéros	ʁi.nɔ.se.ˈʁo
rhododendron	ʁɔ.dɔ.dɛ̃.ˈdʁõ
rhum	ʁɔm
rhumatisme	ʁy.ma.ˈtism
rhume	ʁym
rhénan	ʁe.ˈnã
ricaner	ʁi.ka.ˈne
riche	ʁiʃ
richesse	ʁi.ˈʃɛs
ride	ʁid
rideau	ʁi.ˈdo
rider	ʁi.ˈde
ridicule	ʁi.di.ˈkyl
rien	ʁi
rigide	ʁi.ˈʒid
rigoureux	ʁi.gu.ˈʁø
rimarquer	ʁi.maʁ.ˈke
rime	ʁim
rincer	ʁɛ̃.ˈse
rire	ʁiʁ
risque	ʁisk
risquer	ʁi.ˈske
risque d'accident	ʁisk.dak.ˈsid
rite	ʁit
rival	ʁi.ˈval
rivaliser	ʁi.va.li.ˈze
rivet	ʁi.ˈvɛ
rivière	ʁi.ˈvjɛʁ
rivière Again	ʁi.vjɛ.ʁa.ˈgɛ̃
rivière Atabasca	ʁi.vjɛ.ʁa.ta.ba.ˈska
rivière Bujeault	ʁi.vjɛʁ.by.ˈʒolt
rivière Harricana	ʁi.vjɛ.ʁa.ʁi.ka.ˈna
rivière Joir	ʁi.vjɛʁ.ˈʒwaʁ
rivière Kachekaosipou	ʁi.vjɛʁ.kaʃ.kao.zi.ˈpu
rivière Kedgwick	ʁi.vjɛʁ.kəg.ˈwik
rivière Madawaska	ʁi.vjɛʁ.ma.do.va.ˈska
rivière Magusi	ʁi.vjɛʁ.mag.ˈzi
rivière Mercereau	ʁi.vjɛʁ.mɛʁ.sə.ˈʁo
rivière Napetipi	ʁi.vjɛʁ.na.pə.ti.ˈpi
rivière Natashquan	ʁi.vjɛʁ.na.taz.ˈkã
rivière Natashquan Est	ʁi.vjɛʁ.na.taz.ˈkãɛst
rivière Patapédia	ʁi.vjɛʁ.pa.ta.pe.ˈdja
rivière Piscapecassy	ʁi.vjɛʁ.pi.ska.pə.kas.ˈsi
rivière Rigaud	ʁi.vjɛʁ.ʁi.ˈgo
rivière Rigaud Est	ʁi.vjɛʁ.ʁi.ˈgoɛst
rivière Rimouski	ʁi.vjɛʁ.ʁi.mu.ˈski
rivière Ristigouche	ʁi.vjɛʁ.ʁi.sti.ˈguʃ
rivière Saguenay	ʁi.vjɛʁ.sa.gə.ˈnɛj
rivière Saskachewan Nord	ʁi.vjɛʁ.sa.ska.ʃu.vã.ˈnɔʁ
rivière Saskachewan Sud	ʁi.vjɛʁ.sa.ska.ʃu.vã.ˈsyd
rivière Turcotte	ʁi.vjɛʁ.tyʁ.ˈkɔt
rivière Verte	ʁi.vjɛʁ.ˈvɛʁt
rivière des Outaouais	ʁi.vjɛʁ.deu.ˈtauɛ
rivière de la Paix	ʁi.vjɛʁ.də.la.ˈpɛ
rivière du Détour	ʁi.vjɛʁ.dy.de.ˈtuʁ
rivière du Petit Mécatina	ʁi.vjɛʁ.dy.pə.ti.me.ka.ti.ˈna
rivière à la Pluie	ʁi.vjɛ.ʁa.lapl.ˈɥi
riz	ʁi
robe	ʁɔb
robinet	ʁo.bi.ˈnɛ
robot	ʁo.ˈbo
robuste	ʁɔ.ˈbyst
roc	ʁɔk
rocher	ʁɔ.ˈʃe
roder	ʁɔ.ˈde
roi	ʁwa
roman	ʁo.ˈmã
romantique	ʁo.mã.ˈtik
rompre	ʁõpʁ
rond	ʁõ
ronde	ʁõd
ronfler	ʁõ.ˈfle
ronger	ʁõ.ˈʒe
ronronner	ʁõ.ʁɔ.ˈne
rose	ʁoz
roseau	ʁo.ˈzo
rosse	ʁos
rosser	ʁo.ˈse
rossignol	ʁo.si.ˈnjɔl
rosée	ʁo.ˈze
roter	ʁɔ.ˈte
roue	ʁu
rouge	ʁuʒ
rougir	ʁu.ˈʒiʁ
rouille	ʁuj
rouleau	ʁu.ˈlo
rouler	ʁu.ˈle
roulure	ʁu.ˈlyʁ
roumain	ʁu.ˈmɛ̃
rouspéter	ʁu.spɛ.ˈte
route	ʁut
route aérienne	ʁu.tae.ˈʁjɛn
routine	ʁu.ˈtin
royal	ʁwa.ˈjal
royaume	ʁwa.ˈjom
ruban	ʁy.ˈbã
rubidium	ʁy.bi.ˈdjɔm
rubrique	ʁy.ˈbʁik
ruche	ʁyʃ
rucher	ʁy.ˈʃe
rude	ʁyd
rue	ʁy
ruelle	ʁyɛl
ruine	ʁɥin
ruiner	ʁɥi.ˈne
ruisseau	ʁɥi.ˈso
ruisseau Armstrong	ʁɥi.soaʁm.ˈstʁõŋ
ruisseau Benedict	ʁɥi.so.bən.ˈdikt
ruisseau Burwash	ʁɥi.so.by.ˈʁwaʃ
ruisseau Cedar	ʁɥi.so.sə.ˈdaʁ
ruisseau Chanion	ʁɥi.so.ʃa.ˈnjõ
ruisseau Chisholm	ʁɥi.so.ʃi.ˈʃɔlm
ruisseau Julian	ʁɥi.so.ʒy.ˈljã
ruisseau McDiarmid	ʁɥi.somk.djaʁ.ˈmi
ruisseau Pollard	ʁɥi.so.pɔ.ˈlaʁ
ruisseau Pontiac	ʁɥi.so.põ.ˈtjak
ruisseau Pontleroy	ʁɥi.so.põt.lə.ˈʁwaj
ruisseau Prices	ʁɥi.so.ˈpʁis
ruisseau Quigley	ʁɥi.so.ki.ˈglɛ
ruisseau Saugeen	ʁɥi.so.so.ˈʒi
ruisseau Sisson	ʁɥi.so.si.ˈsõ
ruisseau States Nord	ʁɥi.so.stat.ˈnɔʁ
ruisseau Sunday	ʁɥi.so.sy.ˈdɛj
ruisseau Sunrise	ʁɥi.so.sy.ˈʁiz
ruisseau Teed	ʁɥi.so.ˈti
ruisselet	ʁɥi.sə.ˈlɛ
ruminer	ʁy.mi.ˈne
rupture	ʁyp.ˈtyʁ
rural	ʁy.ˈʁal
russe	ʁys
rustique	ʁy.ˈstik
rusé	ʁy.ˈze
rythme	ʁitm
rythmique	ʁit.ˈmik
rythmé	ʁit.ˈme
réaction	ʁeak.ˈsjõ
réaliser	ʁea.li.ˈze
réalité	ʁea.li.ˈte
récemment	ʁe.ˈsam
réception	ʁe.sɛps.ˈjõ
récif	ʁe.ˈsif
réciproque	ʁe.si.ˈpʁɔk
récit	ʁe.ˈsi
réciter	ʁe.si.ˈte
réclame	ʁe.ˈklam
réclamer	ʁe.kla.ˈme
récolte	ʁe.ˈkɔlt
récolter	ʁe.kɔl.ˈte
récompense	ʁe.kõ.ˈpãs
récompenser	ʁe.kõ.pã.ˈse
réconforter	ʁe.kõ.fɔʁ.ˈte
récréation	ʁe.kʁea.ˈsjõ
récupérer	ʁe.ky.pe.ˈʁe
récurer	ʁe.ky.ˈʁe
rédaction	ʁe.dak.ˈsjõ
rédiger	ʁe.di.ˈʒe
réduction	ʁe.dyk.ˈsjõ
réduction de texte	ʁe.dyk.sjõ.də.ˈtɛkst
réduire	ʁe.ˈdɥiʁ
réduire en miettes	ʁe.dɥiʁ.ˈmjɛt
réel	ʁeɛl
réellement	ʁeɛ.ˈləm
réfectoire	ʁe.fɛk.ˈtwaʁ
réflexion	ʁe.flɛk.ˈsjõ
réfléchir	ʁe.fle.ˈʃiʁ
réformer	ʁe.fɔʁ.ˈme
réfrigérateur	ʁe.fʁi.ʒe.ʁa.ˈtœʁ
réfugié	ʁe.fyʒ.ˈje
réfuter	ʁe.fy.ˈte
régaler	ʁe.ga.ˈle
régime	ʁe.ˈʒim
régiment	ʁe.ˈʒim
région	ʁeʒ.ˈjõ
réglage	ʁe.ˈglaʒ
réglement	ʁe.ˈgləm
régler	ʁe.ˈgle
régner	ʁe.ˈnje
régulier	ʁe.gy.ˈlje
régulièrement	ʁe.gy.ljɛ.ˈʁəm
réjouir	ʁe.ˈʒwiʁ
répandre	ʁe.ˈpãdʁ
réparer	ʁe.pa.ˈʁe
répartir	ʁe.paʁ.ˈtiʁ
répercussion	ʁe.pɛʁ.ky.ˈsjõ
répersussion	ʁe.pɛʁ.sy.ˈsjõ
répondre	ʁe.ˈpõdʁ
réponse	ʁe.ˈpõs
réponse d'un problème	ʁe.põs.dy.pʁo.ˈblɛm
réprimander	ʁe.pʁi.mã.ˈde
réprimer	ʁe.pʁi.ˈme
république	ʁe.py.ˈblik
répulsion	ʁe.pyl.ˈsjõ
réputation	ʁe.py.ta.ˈsjõ
répéter	ʁe.pe.ˈte
réseau	ʁe.ˈzo
réserve	ʁe.ˈzɛʁv
réserver	ʁe.zɛʁ.ˈve
réserver pour	ʁe.zɛʁ.ve.ˈpuʁ
résigner	ʁe.zi.ˈnje
résine	ʁe.ˈzin
résistance	ʁe.zi.ˈstãs
résistance à l'air	ʁe.zi.stã.sa.ˈlɛʁ
résister	ʁe.zi.ˈste
résolution	ʁe.zɔ.ly.ˈtjõ
résonner	ʁe.zɔ.ˈne
résoudre	ʁe.ˈzudʁ
résultat	ʁe.zyl.ˈta
résulter	ʁe.zyl.ˈte
résumer	ʁe.zy.ˈme
rétorquer	ʁe.tɔʁ.ˈke
réunion	ʁey.ˈnjõ
réunir	ʁey.ˈniʁ
réussir	ʁey.ˈsiʁ
réveil	ʁe.ˈvɛj
réveiller	ʁe.ve.ˈje
réviser	ʁe.vi.ˈze
révolte	ʁe.ˈvɔlt
révolution	ʁe.vɔ.ly.ˈtjõ
révéler	ʁe.ve.ˈle
règle	ʁɛgl
règne	ʁɛnj
râler	ʁa.ˈle
râper	ʁa.ˈpe
râteau	ʁa.ˈto
râteler	ʁa.tə.ˈle
rêve	ʁɛv
rêver	ʁɛ.ˈve
rêver éveillé	ʁɛ.vee.ve.ˈje
rôder	ʁo.ˈde
rôle	ʁol
rôtir	ʁo.ˈtiʁ
s.v.p.	ɛs.ve.ˈpe
sa	sa
sable	sabl
sabot	sa.ˈbo
sacoche	sa.ˈkɔʃ
sacré	sa.ˈkʁe
sac tyrolien	sak.ti.ʁɔ.ˈli
sagace	sa.ˈgas
sage	saʒ
sagement	sa.ˈʒəm
sagesse	sa.ˈʒɛs
saillant	sa.ˈjã
sain	sɛ̃
saint	sɛ̃
saisir	sɛ.ˈziʁ
saison	sɛ.ˈzõ
salade	sa.ˈlad
salaire	sa.ˈlɛʁ
salami	sa.la.ˈmi
sale	sal
saler	sa.ˈle
salir	sa.ˈliʁ
salive	sa.ˈliv
salle	sal
salle de bains	sal.də.ˈbɛ̃
salle à manger	sa.la.mã.ˈʒe
salon	sa.ˈlõ
salon de réception	sa.lõ.də.ʁe.sɛps.ˈjõ
saluer	sa.ˈlye
salut	sa.ˈly
salutation	sa.ly.ta.ˈsjõ
samedi	sa.mə.ˈdi
sanction	sãk.ˈsjõ
sandale	sã.ˈdal
sandwich	sã.ˈdwitʃ
sang	sã
sanglier	sãgl.ˈje
sanglot	sã.ˈglo
sangsue	sã.ˈsy
sans	sã
sans doute	sã.ˈdut
sans détour	sã.de.ˈtuʁ
sans faute	sã.ˈfot
santé	sã.ˈte
saper	sa.ˈpe
sapin	sa.ˈpɛ̃
sarcler	saʁ.ˈkle
sardine	saʁ.ˈdin
satellite	sa.tɛ.ˈlit
satisfaire	sa.ti.ˈsfɛʁ
satisfaisant	sa.ti.sfø.ˈzã
satisfait	sa.ti.ˈsfɛ
saturer	sa.ty.ˈʁe
sauce	sos
saucisse	so.ˈsis
sauf	sof
sauge	soʒ
saule	sol
saumon	so.ˈmõ
saut	so
sauter	so.ˈte
sauterelle	so.tə.ˈʁɛl
sauter à l'abordage	so.tea.la.bɔʁ.ˈdaʒ
sautiller	so.ti.ˈje
sauvage	so.ˈvaʒ
sauver	so.ˈve
savant	sa.ˈvã
savoir	sa.ˈvwaʁ
savon	sa.ˈvõ
savourer	sa.vu.ˈʁe
savoureux	sa.vu.ˈʁø
saxophone	sak.so.ˈfɔn
scandale	skã.ˈdal
scandinave	skã.di.ˈnav
scaphandre autonome	ska.fã.dʁo.to.ˈnɔm
scarabée	ska.ʁa.ˈbe
sceau	so
sceller	sɛ.ˈle
sceptique	sɛp.ˈtik
schah	ʃa
schéma	ʃe.ˈma
scie	si
science	sjãs
scier	sje
scintiller	sɛ̃.ti.ˈje
score	skɔʁ
scorpion	skɔʁ.ˈpjõ
scénario	se.na.ˈʁjo
scène	sɛn
se	sə
seau	so
sec	sɛk
second	sə.ˈgõ
secondaire	sə.gõ.ˈdɛʁ
seconde	sə.ˈgõd
secouer	sə.ˈkue
secourir	sə.ku.ˈʁiʁ
secours	sə.ˈkuʁ
secret	sə.ˈkʁɛ
secrétaire	sə.kʁɛ.ˈtɛʁ
secte	sɛkt
secteur	sɛk.ˈtœʁ
section	sɛk.ˈsjõ
sectionner	sɛk.sjɔ.ˈne
seigle	sɛgl
seigneur	sɛ.ˈnjœʁ
seigneurie	sɛ.njœ.ˈʁi
sein	sɛ̃
seize	sɛz
sel	sɛl
selle	sɛl
selon	sə.ˈlõ
semaine	sə.ˈmɛn
semblable	sã.ˈblabl
sembler	sã.ˈble
semelle	sə.ˈmɛl
semence	sə.ˈmãs
semer	sə.ˈme
sens	sãs
sensible	sã.ˈsibl
sensé	sã.ˈse
sentence	sã.ˈtãs
sentier	sã.ˈtje
sentiment	sã.ˈtim
sentinelle	sã.ti.ˈnɛl
sentir	sã.ˈtiʁ
sept	sɛt
septembre	sɛp.ˈtãbʁ
septique	sɛp.ˈtik
serbe	sɛʁb
serein	sə.ˈʁɛ̃
sergent	sɛʁʒ
serment	sɛʁm
sermon	sɛʁ.ˈmõ
sermonner	sɛʁ.mɔ.ˈne
serpe	sɛʁp
serpent	sɛʁp
serrer	sɛ.ˈʁe
serrer plus fort	sɛ.ʁe.ply.ˈfɔʁ
serrure	sɛ.ˈʁyʁ
servage	sɛʁ.ˈvaʒ
servante	sɛʁ.ˈvãt
serveur	sɛʁ.ˈvœʁ
serviable	sɛʁ.ˈvjabl
service	sɛʁ.ˈvis
serviette	sɛʁ.ˈvjɛt
serviette de table	sɛʁ.vjɛt.də.ˈtabl
servir	sɛʁ.ˈviʁ
serviteur	sɛʁ.vi.ˈtœʁ
session	sɛ.ˈsjõ
seuil	sœj
seul	sœl
seulement	sœ.ˈləm
sexe	sɛks
se bagarrer	sə.ba.ga.ˈʁe
se baigner	sə.bɛ.ˈnje
se battre	sə.ˈbatʁ
se conduire	sə.kõ.ˈdɥiʁ
se conformer	sə.kõ.fɔʁ.ˈme
se coucher	sə.ku.ˈʃe
se disputer	sə.di.spy.ˈte
se douter de	sə.du.te.ˈdə
se dresser	sə.dʁɛ.ˈse
se débattre	sə.de.ˈbatʁ
se délecter	sə.de.lɛk.ˈte
se démener	sə.de.mə.ˈne
se déplacer	sə.de.pla.ˈse
se dépêcher	sə.de.pe.ˈʃe
se déshabiller	sə.de.za.bi.ˈje
se dévouer	sə.de.ˈvue
se faner	sə.fa.ˈne
se fatiguer	sə.fa.ti.ˈge
se fier	sə.ˈfje
se fier à	sə.ˈfjea
se lamenter	sə.la.mã.ˈte
se lever	sə.lə.ˈve
se marier	sə.ma.ˈʁje
se masturber	sə.ma.styʁ.ˈbe
se mettre d'accord	sə.mɛtʁ.da.ˈkɔʁ
se mettre en tranvers	sə.mɛtʁ.tʁã.ˈvɛʁ
se mettre en travers	sə.mɛtʁ.tʁa.ˈvɛʁ
se mettre à l'abri	sə.mɛ.tʁa.la.ˈbʁi
se mettre à l'abri de	sə.mɛ.tʁa.la.bʁi.ˈdə
se méfier	sə.me.ˈfje
se perdre	sə.ˈpɛʁdʁ
se plaindre	sə.ˈplɛ̃dʁ
se porter	sə.pɔʁ.ˈte
se promener	sə.pʁo.mə.ˈne
se précipiter	sə.pʁe.si.pi.ˈte
se quereller	sə.kə.ʁɛ.ˈle
se racornir	sə.ʁa.kɔʁ.ˈniʁ
se rappeler	sə.ʁa.pə.ˈle
se ratatiner	sə.ʁa.ta.ti.ˈne
se recommander	sə.ʁə.ko.mã.ˈde
se relâcher	sə.ʁə.la.ˈʃe
se rendre compte	sə.ʁãdʁ.ˈkõt
se repentir	sə.ʁə.pã.ˈtiʁ
se reposer	sə.ʁə.po.ˈze
se retirer	sə.ʁə.ti.ˈʁe
se retrancher	sə.ʁə.tʁã.ˈʃe
se réfugier	sə.ʁe.fyʒ.ˈje
se réjouir	sə.ʁe.ˈʒwiʁ
se réserver	sə.ʁe.zɛʁ.ˈve
se résigner	sə.ʁe.zi.ˈnje
se résoudre à	sə.ʁe.zu.ˈdʁa
se réveiller	sə.ʁe.ve.ˈje
se révolter	sə.ʁe.vɔl.ˈte
se servir de	sə.sɛʁ.viʁ.ˈdə
se soucier de	sə.su.sje.ˈdə
se soulever	sə.su.lə.ˈve
se souvenir	sə.su.və.ˈniʁ
se suicider	sə.sɥi.si.ˈde
se surveiller	sə.syʁ.vɛ.ˈje
se taire	sə.ˈtɛʁ
se terminer	sə.tɛʁ.mi.ˈne
se tromper	sə.tʁõ.ˈpe
se trouver	sə.tʁu.ˈve
shah	za
shérif	ʃe.ˈʁif
si	si
siamois	sja.ˈmwa
sibérien	si.be.ˈʁi
sicilien	si.si.ˈli
sida	si.ˈda
siffler	si.ˈfle
sifflet	si.ˈflɛ
signal	si.ˈnjal
signaler	si.nja.ˈle
signature	si.nja.ˈtyʁ
signe	sinj
signer	si.ˈnje
signification	si.nji.fi.ka.ˈsjõ
signifier	si.nji.ˈfje
silencieux	si.lã.ˈsjø
silex	si.ˈlɛks
silhouette	si.ˈlwɛt
sillon	si.ˈjõ
simple	sɛ̃pl
simulacre	si.my.ˈlakʁ
sincérité	sɛ̃.se.ʁi.ˈte
sincère	sɛ̃.ˈsɛʁ
singaporien	sɛ̃.ga.pɔ.ˈʁi
singe	sɛ̃ʒ
singulier	sɛ̃.gy.ˈlje
sinistre	si.ˈnistʁ
sirop	si.ˈʁo
sirène	si.ˈʁɛn
situation	si.tya.ˈsjõ
situer	si.ˈtye
sitôt	si.ˈto
six	sis
siècle	sjɛkl
siège	sjɛʒ
sièger	sjɛ.ˈʒe
ski	ski
slave	slav
slavon	sla.ˈvõ
slip	slip
slip de bain	slip.də.ˈbɛ̃
slovaque	slo.ˈvak
slovène	slo.ˈvɛn
sobre	sɔbʁ
social	so.ˈsjal
socialisme	so.sja.ˈlism
société	sɔ.sje.ˈte
sodium	so.ˈdjɔm
soie	swa
soif	swaf
soigner	swa.ˈnje
soin	swɛ̃
soir	swaʁ
soirée	swa.ˈʁe
soit	swa
soit ... soit	swa.ˈswa
soixante	swa.ˈsãt
soixantième	swa.sã.ˈtjɛm
sol	sɔl
soldat	sɔl.ˈda
solde	sɔld
sole	sɔl
soleil	sɔ.ˈlɛj
solennel	sɔ.lã.ˈnɛl
solidaire	sɔ.li.ˈdɛʁ
solidarité	sɔ.li.da.ʁi.ˈte
solide	sɔ.ˈlid
solliciter	sɔ.li.si.ˈte
somalien	so.ma.ˈli
sombre	sõbʁ
sommation	sɔ.ma.ˈsjõ
somme	sɔm
sommeil	sɔ.ˈmej
sommer	sɔ.ˈme
sommet	sɔ.ˈmɛ
son	sõ
songe	sõʒ
songer	sõ.ˈʒe
sonner	sɔ.ˈne
sonner à la porte	sɔ.nea.la.ˈpɔʁt
sonnette	so.ˈnɛt
sonore	so.ˈnɔʁ
sorcier	sɔʁ.ˈsje
sorcière	sɔʁ.ˈsjɛʁ
sort	sɔʁ
sorter	sɔʁ.ˈte
sortie	sɔʁ.ˈti
sortilège	sɔʁ.ti.ˈlɛʒ
sortir de	sɔʁ.tiʁ.ˈdə
sot	so
souci	su.ˈsi
soucoupe	su.ˈkup
soudain	su.ˈdɛ̃
soudainement	su.dɛ.ˈnəm
soudanais	su.da.ˈnɛ
souder	su.ˈde
souffle	sufl
souffler	su.ˈfle
souffler sur	su.fle.ˈsyʁ
souffrir	su.ˈfʁiʁ
soufre	sufʁ
souhait	swɛ
souhaiter	swɛ.ˈte
souiller	su.ˈje
soulager	su.la.ˈʒe
soulever	su.lə.ˈve
soulier	su.ˈlje
souligner	su.li.ˈnje
soumettre	su.ˈmɛtʁ
soupe	sup
souper	su.ˈpe
soupirant	su.pi.ˈʁã
soupirer	su.pi.ˈʁe
souple	supl
souplesse	su.ˈplɛs
soupçonner	su.psɔ.ˈne
source	suʁs
sourcil	suʁ.ˈsil
sourd	suʁ
sourire	su.ˈʁiʁ
souris	su.ˈʁi
sous	su
soustraction	su.stʁak.ˈsjõ
soustraire	su.ˈstʁɛʁ
soutenir	su.tə.ˈniʁ
souterrain	su.tɛ.ˈʁɛ̃
souvenir	su.və.ˈniʁ
souvent	suv
souverain	su.və.ˈʁɛ̃
soyeux	swa.ˈjø
speaker	spi.ˈke
spectacle	spɛk.ˈtakl
spectacle de variété	spɛk.takl.də.va.ʁjɛ.ˈte
spectateur	spɛk.ta.ˈtœʁ
sperme	spɛʁm
sphère	sfɛʁ
spirale	spi.ˈʁal
spirituel	spi.ʁi.ˈtyɛl
splendeur	splã.ˈdœʁ
splendide	splã.ˈdid
spontané	spõ.ta.ˈne
sport	spɔʁ
spécial	spe.ˈsjal
spécialement	spe.sja.ˈləm
spécialité	spe.sja.li.ˈte
spécimen	spe.si.ˈmɛn
squelette	skə.ˈlɛt
stable	stabl
stade	stad
stagner	stag.ˈne
stand	stã
standard	stã.ˈdaʁ
star	staʁ
station	sta.ˈsjõ
stationner	sta.sjɔ.ˈne
statue	sta.ˈty
stature	sta.ˈtyʁ
statut	sta.ˈty
steppe	stɛp
stimuler	sti.my.ˈle
stock	stɔk
store	stɔʁ
store vénitien	stɔʁ.ve.ni.ˈti
stratégie	stʁa.te.ˈʒi
strict	stʁikt
strident	stʁid
strontium	stʁõ.ˈsiɔm
strophe	stʁɔf
structure	stʁyk.ˈtyʁ
stuc	styk
studio	sty.ˈdjo
stupeur	sty.ˈpœʁ
stupide	sty.ˈpid
stupidement	sty.pi.ˈdəm
stupéfaction	sty.pe.fak.ˈsjõ
stupéfait	sty.pe.ˈfɛ
stupéfiant	sty.pe.ˈfjã
stupéfier	sty.pe.ˈfje
style	stil
stylo	sti.ˈlo
stylo à bille	sti.loa.ˈbij
suave	syav
subir	sy.ˈbiʁ
subit	sy.ˈbi
subitement	sy.bi.ˈtəm
subordonné	sy.boʁ.dɔ.ˈne
substance	syb.ˈstãs
substituer	syb.sti.ˈtye
subtil	syb.ˈti
subvention	syb.vã.ˈtjõ
suc	syk
successeur	syk.sɛ.ˈsœʁ
succession	syk.sɛ.ˈsjõ
successivement	syk.sɛ.si.ˈvəm
succulent	sy.ˈkyl
succursale	sy.kyʁ.ˈsal
succès	syk.ˈsɛ
sucer	sy.ˈse
sucette	sy.ˈsɛt
sucre	sykʁ
sucré	sy.ˈkʁe
sud	syd
suer	sye
sueur	syœʁ
suffire	sy.ˈfiʁ
suffisamment	sy.fi.ˈzam
suffisant	sy.fi.ˈzã
suffixe	sy.ˈfiks
suffoquer	sy.fɔ.ˈke
suggérer	syg.ʒe.ˈʁe
suie	sɥi
suisse	sɥis
suite	sɥit
suivant	sɥi.ˈvã
suivre	sɥivʁ
sujet	sy.ˈʒɛ
sujet secondaire	sy.ʒɛ.sə.gõ.ˈdɛʁ
summon	sy.ˈmõ
superbe	sy.ˈpɛʁb
superficiel	sy.pɛʁ.fi.ˈsjɛl
superstition	sy.pɛʁ.sti.ˈsjõ
supplément	sy.ˈplem
supplémentaire	sy.ple.mã.ˈtɛʁ
supporter	sy.pɔʁ.ˈte
supposer	sy.po.ˈze
supposé que	sy.po.ze.ˈkə
supprimer	sy.pʁi.ˈme
suprème	sy.ˈpʁɛm
supérieur	sy.pe.ˈʁjœʁ
sur	syʁ
sureau	sy.ˈʁo
surface	syʁ.ˈfas
surgir	syʁ.ˈʒiʁ
surinamien	sy.ʁi.na.ˈmi
surmonter	syʁ.mõ.ˈte
surplombant	syʁ.plõ.ˈbã
surprendre	syʁ.ˈpʁãdʁ
surprise	syʁ.ˈpʁiz
sursauter	syʁ.so.ˈte
sursis	syʁ.ˈsi
surtout	syʁ.ˈtu
surveiller	syʁ.vɛ.ˈje
sur la recommandation de	syʁ.la.ʁə.ko.mã.da.sjõ.ˈdə
suspecter	sy.spɛk.ˈte
suspendre	sy.ˈspãdʁ
sussurer	sy.sy.ˈʁe
suédois	sye.ˈdwa
symbole	sɛ̃.ˈbɔl
sympa	sɛ̃.ˈpa
sympathie	sɛ̃.pa.ˈti
sympathique	sɛ̃.pa.ˈtik
syndicat	sɛ̃.di.ˈka
syndicat agricole	sɛ̃.di.kaa.gʁi.ˈkɔl
syrien	sɛ̃.ˈʁi
système	si.ˈstɛm
s'abaisser	sa.bɛ.ˈse
s'abattre	sa.ˈbatʁ
s'abonner	sa.bɔ.ˈne
s'aboucher avec	sa.bu.ʃea.ˈvɛk
s'abouler	sa.bu.ˈle
s'abriter	sa.bʁi.ˈte
s'absenter	sab.sɛ̃.ˈte
s'abstenir	sab.stə.ˈniʁ
s'abstenir de	sab.stə.niʁ.ˈdə
s'abâtardir	sa.ba.taʁ.ˈdiʁ
s'abêtir	sa.bɛ.ˈtiʁ
s'abîmer	sa.bi.ˈme
s'acclimater	sa.kli.ma.ˈte
s'accorder	sa.kɔʁ.ˈde
s'accoter	sa.kɔ.ˈte
s'accoupler	sa.ku.ˈple
s'accoutumer	sa.ku.ty.ˈme
s'accoître	sa.ˈkwatʁ
s'accroître	sa.ˈkʁwatʁ
s'acidifier	sa.si.di.ˈfje
s'adapter	sa.dap.ˈte
s'adjoindre des aides	sad.ʒwɛ̃dʁ.ˈdeɛd
s'adosser	sa.do.ˈse
s'adresser à	sa.dʁɛ.ˈsea
s'affilier	sa.fi.ˈlje
s'agenouiller	sa.ʒə.nu.ˈje
s'agglutiner	sa.gly.ti.ˈne
s'aigrir	sɛ.ˈgʁiʁ
s'ajuster	sa.ʒy.ˈste
s'allumer	sa.ly.ˈme
s'amoindrir	sa.mwɛ̃.ˈdʁiʁ
s'amuser	sa.my.ˈze
s'apercevoir	sa.pɛʁ.sə.ˈvwaʁ
s'apitoyer	sa.pi.twa.ˈje
s'appeler	sa.pə.ˈle
s'approcher	sa.pʁɔ.ˈʃe
s'arrêter	sa.ʁɛ.ˈte
s'arrêter à	sa.ʁɛ.ˈtea
s'attabler	sa.ta.ˈble
s'avancer	sa.vã.ˈse
s'efforcer	sɛ.fɔʁ.ˈse
s'enfuir	sã.ˈfɥiʁ
s'engager	sã.ga.ˈʒe
s'enivrer	sə.ni.ˈvʁe
s'ennuyer	sã.nɥi.ˈje
s'entremettre	sã.tʁə.ˈmɛtʁ
s'en aller	sa.ˈle
s'excuser	sɛk.sky.ˈze
s'habiller	sa.bi.ˈje
s'harmoniser	saʁ.mo.ni.ˈze
s'humilier	sy.mi.ˈlje
s'il vous plaît	svu.ˈplɛ
s'incliner	sɛ̃.kli.ˈne
s'indigner	sɛ̃.di.ˈnje
s'indigner de	sɛ̃.di.nje.ˈdə
s'informer	si.fɔʁ.ˈme
s'intéresser	si.te.ʁe.ˈse
s'obstiner	sob.sti.ˈne
s'occuper	so.ky.ˈpe
s'occuper de	so.ky.pe.ˈdə
s'ébattre	se.ˈbatʁ
s'échapper	se.ʃa.ˈpe
s'élancer	se.lã.ˈse
s'ériger en	se.ʁi.ˈʒe
s'étendre	se.ˈtãdʁ
s'étonner	se.tɔ.ˈne
s'évanouir	se.va.ˈnwiʁ
s'éveiller	se.ve.ˈje
séance	seãs
sécher	se.ˈʃe
sécurité	se.ky.ʁi.ˈte
séditieux	se.di.ˈsjø
séisme	seism
séjour	se.ˈʒuʁ
sémitique	se.mi.ˈtik
séparer	se.pa.ˈʁe
série	se.ˈʁi
sérieux	se.ˈʁjø
sévère	se.ˈvɛʁ
sèchement	sɛ.ˈʃəm
sève	sɛv
sûr	syʁ
sûrement	sy.ˈʁəm
ta	ta
tabac	ta.ˈba
table	tabl
tableau	ta.ˈblo
tableau d'affichage	ta.blo.da.fi.ˈʃaʒ
tablette	ta.ˈblɛt
tablier	tabl.ˈje
tabouret	ta.bu.ˈʁɛ
tache	taʃ
tact	takt
tactique	tak.ˈtik
taille	taj
tailler	ta.ˈje
tailleur	ta.ˈjœʁ
talon	ta.ˈlõ
talon d'Achille	ta.lõ.da.ˈʃi
tambour	tã.ˈbuʁ
tamiser	ta.mi.ˈze
tampon	tã.ˈpõ
tandis que	tã.di.ˈkə
tank	tãk
tant	tã
tante	tãt
tanzanien	tã.za.ˈni
taon	tã
taper	ta.ˈpe
tapis	ta.ˈpi
tapisser	ta.pi.ˈse
tapisserie	ta.pi.sə.ˈʁi
taquiner	ta.ki.ˈne
tarder	taʁ.ˈde
tarif postal	ta.ʁif.po.ˈstal
tarte	taʁt
tas	ta
tasse	tas
tasser	ta.ˈse
tatare	ta.ˈtaʁ
taupe	top
taureau	to.ˈʁo
taxe	taks
taxer	tak.ˈse
taxe d'octroi	taks.dok.ˈtʁwa
taxi	tak.ˈsi
taïlandais	tai.lã.ˈdɛ
taïs	tai
tchécoslovaque	tʃe.kos.lo.ˈvak
tchèque	tʃɛk
te	tə
technique	tɛk.ˈnik
teindre	tɛ̃dʁ
teint	tɛ̃
teinte	tɛ̃t
tel	tɛl
tellement	tɛ.ˈləm
tempe	tãp
temple	tãpl
temporaire	tã.po.ˈʁɛʁ
temps	tã
température	tã.pe.ʁa.ˈtyʁ
tempête	tã.ˈpɛt
tenace	tə.ˈnas
tenailles	tə.ˈnaj
tendance	tã.ˈdãs
tendon d'Achille	tã.dõ.da.ˈʃi
tendre	tãdʁ
tendresse	tã.ˈdʁɛs
tendre un piège	tã.dʁœ̃.ˈpjɛʒ
tenir	tə.ˈniʁ
tenir place de	tə.niʁ.plas.ˈdə
tension	tã.ˈsjõ
tentation	tã.ta.ˈsjõ
tente	tãt
tenter	tã.ˈte
tenue	tə.ˈny
terme	tɛʁm
terminer	tɛʁ.mi.ˈne
terminus	tɛʁ.mi.ˈny
terrain	tɛ.ˈʁɛ̃
terrasse	tɛ.ˈʁas
terre	tɛʁ
terrer	tɛ.ˈʁe
terrestre	tɛ.ˈʁɛstʁ
terreur	tɛ.ˈʁœʁ
terrible	tɛ.ˈʁibl
territoire	tɛ.ʁi.ˈtwaʁ
territoire du Yukon	tɛ.ʁi.twaʁ.dy.jy.ˈkõ
testament	tɛ.ˈstam
testicule	tɛ.sti.ˈkyl
texte	tɛkst
textile	tɛk.ˈstil
thaïlandais	tai.lã.ˈdɛ
thermomètre	tɛʁ.mo.ˈmɛtʁ
thon	tõ
thé	te
théière	te.ˈjɛʁ
théocratie	teo.kʁa.ˈsi
théorie	teɔ.ˈʁi
théâtre	teatʁ
thème	tɛm
thèse	tɛz
tibétain	ti.bɛ.ˈtɛ̃
ticket	ti.ˈkɛ
tien	ti
tiers	tje
tige	tiʒ
tigre	tigʁ
tilleul	ti.ˈjœl
timbre	tɛ̃bʁ
timbre de poste aérienne	tɛ̃bʁ.də.pɔ.stae.ˈʁjɛn
timide	ti.ˈmid
tinter	tɛ̃.ˈte
tique	tik
tir	tiʁ
tirer	ti.ˈʁe
tirer au sort	ti.ʁeo.ˈsɔʁ
tirer un trait	ti.ʁeœ̃.ˈtʁɛ
tiroir	ti.ˈʁwaʁ
tisser	ti.ˈse
tissu	ti.ˈsy
titane	ti.ˈtan
titre	titʁ
tiède	tjɛd
toi	twa
toile	twal
toilette	twa.ˈlɛt
toit	twa
tolérer	tɔ.le.ˈʁe
tomate	to.ˈmat
tombe	tõb
tomber	tõ.ˈbe
tomber amoureux de	tõ.bea.mu.ʁø.ˈdə
ton	tõ
tondre	tõdʁ
tonne	tɔn
tonneau	to.ˈno
tonnelle	to.ˈnɛl
tonner	tɔ.ˈne
tonnerre	tɔ.ˈnɛʁ
ton aigre	tõɛgʁ
toquade	tɔ.ˈkad
toque	tɔk
torche	tɔʁʃ
torchon	tɔʁ.ˈʃõ
tordre	tɔʁdʁ
torpiller	tɔʁ.pi.ˈje
torrent	toʁ
torse	tɔʁs
tortue	toʁ.ˈty
torture	toʁ.ˈtyʁ
total	to.ˈtal
totalement	to.ta.ˈləm
touche	tuʃ
toucher	tu.ˈʃe
toucher à	tu.ˈʃea
touche de clavier	tuʃ.də.kla.ˈvje
touffu	tu.ˈfy
toujours	tu.ˈʒuʁ
toujours plus	tu.ʒuʁ.ˈply
tour	tuʁ
tourbe	tuʁb
tourbilloner	tuʁ.bi.jo.ˈne
tourisme	tu.ˈʁism
tourmenter	tuʁ.mã.ˈte
tourner	tuʁ.ˈne
tournevis	tuʁ.nə.ˈvi
tourterelle	tuʁ.tə.ˈʁɛl
tous	tu
tousser	tu.ˈse
tous les jours	tu.le.ˈʒuʁ
tous près de	tu.pʁɛ.ˈdə
tout	tu
toutes	tut
toutes les fois	tut.le.ˈfwa
toute espèce de	tu.tɛ.spɛs.ˈdə
toute sorte de	tut.sɔʁt.ˈdə
tout au plus	tuo.ˈply
tout de même	tu.də.ˈmɛm
tout de suite	tu.də.ˈsɥit
tout d'abord	tu.da.ˈbɔʁ
tout le	tu.ˈlə
tout le monde	tu.lə.ˈmõd
tout à coup	tua.ˈku
tout à l'heure	tua.ˈlœʁ
trace	tʁas
trachée	tʁa.ˈʃe
tracteur	tʁak.ˈtœʁ
tradition	tʁa.di.ˈsjõ
traduire	tʁa.ˈdɥiʁ
trafic	tʁa.ˈfik
tragique	tʁa.ˈʒik
tragédie	tʁa.ʒe.ˈdi
trahir	tʁaiʁ
train	tʁɛ̃
traire	tʁɛʁ
trait	tʁɛ
traiter	tʁɛ.ˈte
trajectoire	tʁa.ʒɛk.ˈtwaʁ
tramer	tʁa.ˈme
tramway	tʁa.ˈmwɛ
tranchant	tʁã.ˈʃã
trancher	tʁã.ˈʃe
tranquille	tʁã.ˈkij
transformation	tʁã.sfɔʁ.ma.ˈsjõ
transformer	tʁã.sfɔʁ.ˈme
transitif	tʁã.zi.ˈtif
transmission	tʁã.smi.ˈsjõ
transpirer	tʁã.spi.ˈʁe
transport	tʁã.ˈspɔʁ
transporter	tʁã.spɔʁ.ˈte
travailler	tʁa.va.ˈje
traîner	tʁɛ.ˈne
traître	tʁɛtʁ
treize	tʁɛz
treizième	tʁɛz.ˈjɛm
tremble	tʁãbl
tremblement de terre	tʁã.bləm.də.ˈtɛʁ
trembler	tʁã.ˈble
tremper	tʁã.ˈpe
trente	tʁãt
tresser	tʁɛ.ˈse
triangle	tʁjãgl
triangulaire	tʁjã.gy.ˈlɛʁ
tribu	tʁi.ˈby
tribunal	tʁi.by.ˈnal
tribune	tʁi.ˈbyn
tribut	tʁi.ˈby
tricher	tʁi.ˈʃe
tricoter	tʁi.kɔ.ˈte
trier	tʁie
triomphe	tʁiõf
triompher	tʁiõ.ˈfe
triste	tʁist
trivial	tʁi.ˈvjal
trois	tʁwa
trombone	tʁõ.ˈbɔn
trompe	tʁõp
tromper	tʁõ.ˈpe
trompette	tʁõ.ˈpɛt
tronc	tʁõ
trop	tʁo
tropical	tʁo.pi.ˈkal
trotter	tʁɔ.ˈte
trottoir	tʁo.ˈtwaʁ
trou	tʁu
trouble	tʁubl
troubler	tʁu.ˈble
troupe	tʁup
troupeau	tʁu.ˈpo
trouver	tʁu.ˈve
troène	tʁoɛn
trucs	tʁyk
truie	tʁɥi
truite	tʁɥit
trébucher	tʁe.by.ˈʃe
trésor	tʁe.ˈzɔʁ
trésorier	tʁe.zɔ.ˈʁje
très	tʁɛ
trêve	tʁɛv
tu	ty
tube	tyb
tuer	tye
tungstène	ty.ˈstɛn
tunnel	ty.ˈnɛl
tutoyer	ty.twa.ˈje
tuyau	tɥi.ˈjo
tylenchus	ti.lã.ˈʃy
type	tip
typhus	ti.ˈfys
tyran	ti.ˈʁã
tzigane	dzi.ˈgan
t'	t
télégramme	te.le.ˈgʁam
télégraphe	te.le.ˈgʁaf
téléphone	te.le.ˈfɔn
téléphoner	te.le.fɔ.ˈne
télévision	te.le.viz.ˈjõ
témoignage	te.mwa.ˈnjaʒ
témoigner	te.mwa.ˈnje
témoin	te.ˈmwɛ̃
ténèbres	te.ˈnɛbʁ
ténères	te.ˈnɛʁ
tâche	taʃ
tâter	ta.ˈte
tête	tɛt
tête de bétail	tɛt.də.be.ˈtaj
tête d'ail	tɛt.ˈdaj
têtu	tɛ.ˈty
tôle	tol
tôt	to
ukrainien	y.kʁɛ.ˈni
ulcère	yl.ˈsɛʁ
un	œ̃
une	yn
une certaine quantité	yn.sɛʁ.tɛn.kã.ti.ˈte
uni	y.ˈni
uniforme	y.ni.ˈfɔʁm
unique	y.ˈnik
unir	y.ˈniʁ
unité	y.ni.ˈte
univers	y.ni.ˈvɛʁ
université	y.ni.vɛʁ.si.ˈte
un jour	œ̃.ˈʒuʁ
uranium	y.ʁa.ˈnjɔm
uriner	y.ʁi.ˈne
user	y.ˈze
user de	y.ze.ˈdə
usine	y.ˈzin
ustensile	y.stã.ˈsil
utile	y.ˈtil
utérus	y.te.ˈʁy
vacance	va.ˈkãs
vacances	va.ˈkãs
vacciner	vak.si.ˈne
vache	vaʃ
vaciller	va.si.ˈje
vagin	va.ˈʒɛ̃
vague	vag
vaguer	va.ˈge
vaillant	va.ˈjã
vain	vɛ̃
vaincre	vɛ̃kʁ
valable	va.ˈlabl
valeur	va.ˈlœʁ
valise	va.ˈliz
vallée	va.ˈle
valoir	va.ˈlwaʁ
valve	valv
vaniteux	va.ni.ˈtø
vanité	va.ni.ˈte
vapeur	va.ˈpœʁ
varier	va.ˈʁje
variété	va.ʁjɛ.ˈte
vase	vaz
vautour	vo.ˈtuʁ
veau	vo
vedette	və.ˈdɛt
veiller sur	vɛ.je.ˈsyʁ
veiller à	vɛ.ˈjea
veine	vɛn
velours	və.ˈluʁ
velu	və.ˈly
vendre	vãdʁ
vendredi	vã.dʁə.ˈdi
vendre d'occasion	vãdʁ.do.kaz.ˈjõ
venger	vã.ˈʒe
venimeux	və.ni.ˈmø
venin	və.ˈnɛ̃
venir	və.ˈniʁ
vent	v
vente aux enchères	vã.toã.ˈʃɛʁ
ventiler	vã.ti.ˈle
ventre	vãtʁ
venue	və.ˈny
ver	ve
verbe	vɛʁb
verdict	vɛʁ.ˈdikt
verger	vɛʁ.ˈʒe
vernis	vɛʁ.ˈni
verrat	vɛ.ˈʁa
verre	vɛʁ
verrouiller	vɛ.ʁu.ˈje
verrue	vɛ.ˈʁy
vers	vɛʁ
versement	vɛʁ.ˈsəm
versement initial	vɛʁ.sə.mi.ni.ˈsjal
verser	vɛʁ.ˈse
verser un premier acompte	vɛʁ.seœ̃.pʁə.mjea.ˈkõt
vert	vɛʁ
vertical	vɛʁ.ti.ˈkal
vertu	vɛʁ.ˈty
vertèbre	vɛʁ.ˈtɛbʁ
ver de terre	ve.də.ˈtɛʁ
vessie	vɛ.ˈsi
veste	vɛst
vestiaire	vɛst.ˈjɛʁ
veston	vɛ.ˈstõ
veuf	vœf
veuillez m'excuser	vœ.je.mɛk.sky.ˈze
veuve	vœv
viande	vjãd
vibrer	vi.ˈbʁe
vice	vis
victime	vik.ˈtim
vide	vid
vider	vi.ˈde
vie	vi
vieillard	vjɛ.ˈjaʁ
viennois	vjɛ.ˈnwa
vierge	vjɛʁʒ
vietnamien	vjɛt.na.ˈmi
vieux	vjø
vif	vif
vigilant	vi.ʒi.ˈlã
vigne	vinj
vignoble	vi.ˈnjɔbl
vigueur	vi.ˈgœʁ
vilain	vi.ˈlɛ̃
villa	vi.ˈla
village	vi.ˈlaʒ
villageois	vi.la.ˈʒwa
ville	vil
vin	vɛ̃
vinaigre	vi.ˈnɛgʁ
vingt	vɛ̃
vingtième	vɛ̃.ˈtjɛm
violer	vjɔ.ˈle
violet	vjo.ˈlɛ
violette	vjo.ˈlɛt
violon	vjo.ˈlõ
violoncelle	vjo.lõ.ˈsɛl
virer	vi.ˈʁe
virginal	viʁ.ʒi.ˈnal
virgule	viʁ.ˈgyl
virus	vi.ˈʁys
vis	vi
visa	vi.ˈza
visage	vi.ˈzaʒ
viser	vi.ˈze
visible	vi.ˈzibl
vision	viz.ˈjõ
visite	vi.ˈzit
visiter	vi.zi.ˈte
visiteur	vi.zi.ˈtœʁ
vite	vit
vitesse	vi.ˈtɛs
vitre	vitʁ
vitrine	vi.ˈtʁin
vivant	vi.ˈvã
vive sollicitation	viv.sɔ.li.si.ta.ˈsjõ
vivre	vivʁ
vodka	vod.ˈka
voici	vwa.ˈsi
voie	vwa
voile	vwal
voiler	vwa.ˈle
voilà	vwa.ˈla
voir	vwaʁ
voisin	vwa.ˈzɛ̃
voisinage	vwa.zi.ˈnaʒ
voiture	vwa.ˈtyʁ
voix	vwa
volant	vɔ.ˈlã
volcan	vɔl.ˈkã
voler	vɔ.ˈle
volontaire	vɔ.lõ.ˈtɛʁ
volontiers	vɔ.lõ.ˈtje
volonté	vɔ.lõ.ˈte
volt	vɔlt
voltiger	vɔl.ti.ˈʒe
volume	vo.ˈlym
volupté	vo.lyp.ˈte
vomir	vo.ˈmiʁ
votre	vɔtʁ
vouloir	vu.ˈlwaʁ
vous	vu
voyage	vwa.ˈjaʒ
voyager	vwa.ja.ˈʒe
voyager au loin	vwa.ja.ʒeo.ˈlwɛ̃
voyageur	vwa.ja.ˈʒœʁ
voyelle	vwa.ˈjɛl
voûte	vut
vrai	vʁɛ
vraiment	vʁɛm
vraisamblable	vʁɛ.zã.ˈblabl
vraisemblable	vʁɛ.sã.ˈblabl
vrille	vʁij
vrombir	vʁõ.ˈbiʁ
vue	vy
vulgaire	vyl.ˈgɛʁ
vu que	vy.ˈkə
végéter	ve.ʒe.ˈte
véhicle	veikl
vélo	ve.ˈlo
vélomoteur	ve.lɔ.mɔ.ˈtœʁ
véreux	ve.ˈʁø
vérifier	ve.ʁi.ˈfje
véritable	ve.ʁi.ˈtabl
véronique	ve.ʁo.ˈnik
vésicule	ve.zi.ˈkyl
vêtements	vɛ.ˈtəm
vêtir	vɛ.ˈtiʁ
vôtre	votʁ
wagon	va.ˈgõ
wallon	wa.ˈlõ
whisky	wi.ˈski
xylophone	ksi.lo.ˈfɔn
xénon	kse.ˈnõ
yaourt	jauʁ
yen	jɛn
yoga	jɔ.ˈga
yoghourt	jo.ˈguʁ
yogourt	jo.ˈguʁ
yougoslave	ju.gos.ˈlav
zambien	zã.ˈbi
zapper	za.ˈpe
zinc	zɛ̃g
zip	zip
zob	zɔb
zone	zon
zoo	zɔo
zélandais	ze.lã.ˈdɛ
zéro	ze.ˈʁo
zèbre	zɛbʁ
zèle	zɛl

